"Airports";"Periods";"Aircraft movements/Cross-country flights (number)";"Aircraft movements/Local flights (number)";"Commercial air traffic/Flights/Arrivals/Total arrivals flights (number)";"Commercial air traffic/Flights/Arrivals/Scheduled (number)";"Commercial air traffic/Flights/Arrivals/Non-scheduled (number)";"Commercial air traffic/Flights/Departures/Total departures flights (number)";"Commercial air traffic/Flights/Departures/Scheduled (number)";"Commercial air traffic/Flights/Departures/Non-scheduled (number)";"Commercial air traffic/Passengers/Passenger arrivals/Total arrivals passengers (number)";"Commercial air traffic/Passengers/Passenger arrivals/Scheduled (number)";"Commercial air traffic/Passengers/Passenger arrivals/Non-scheduled (number)";"Commercial air traffic/Passengers/Passenger departures/Total departures passengers (number)";"Commercial air traffic/Passengers/Passenger departures/Scheduled (number)";"Commercial air traffic/Passengers/Passenger departures/Non-scheduled (number)";"Commercial air traffic/Passengers/Country of origin/destination/Total country of origin/destination (number)";"Commercial air traffic/Passengers/Country of origin/destination/Europe/Europe total (number)";"Commercial air traffic/Passengers/Country of origin/destination/Europe/EU countries (number)";"Commercial air traffic/Passengers/Country of origin/destination/Europe/Other Europe (number)";"Commercial air traffic/Passengers/Country of origin/destination/Intercontinental/Total intercontinental passengers (number)";"Commercial air traffic/Passengers/Country of origin/destination/Intercontinental/Africa/Africa (number)";"Commercial air traffic/Passengers/Country of origin/destination/Intercontinental/Africa/North Africa (number)";"Commercial air traffic/Passengers/Country of origin/destination/Intercontinental/Africa/West Africa (number)";"Commercial air traffic/Passengers/Country of origin/destination/Intercontinental/Africa/Central Africa (number)";"Commercial air traffic/Passengers/Country of origin/destination/Intercontinental/Africa/East Africa (number)";"Commercial air traffic/Passengers/Country of origin/destination/Intercontinental/Africa/South Africa (number)";"Commercial air traffic/Passengers/Country of origin/destination/Intercontinental/America/America (number)";"Commercial air traffic/Passengers/Country of origin/destination/Intercontinental/America/North America (number)";"Commercial air traffic/Passengers/Country of origin/destination/Intercontinental/America/Central America (number)";"Commercial air traffic/Passengers/Country of origin/destination/Intercontinental/America/South America (number)";"Commercial air traffic/Passengers/Country of origin/destination/Intercontinental/Asia/Asia (number)";"Commercial air traffic/Passengers/Country of origin/destination/Intercontinental/Asia/West Asia (number)";"Commercial air traffic/Passengers/Country of origin/destination/Intercontinental/Asia/South-East Asia (number)";"Commercial air traffic/Passengers/Country of origin/destination/Intercontinental/Asia/North-East Asia (number)";"Commercial air traffic/Passengers/Country of origin/destination/Intercontinental/Oceania (number)";"Commercial air traffic/Passengers/Country of origin/destination/Intercontinental/Other/unknown (number)";"Commercial air traffic/Passengers/Country of origin/destination/Unknown (number)"
"Amsterdam Airport Schiphol";"1999 January";"   30391";"     672";"   14816";"   14103";"     713";"   14824";"   14074";"     750";" 1192304";" 1112747";"   79557";" 1180274";" 1104118";"   76156";" 2372578";" 1496494";" 1256091";"  240403";"  876084";"  113309";"   41140";"   26043";"       0";"   22468";"   23658";"  455002";"  334326";"   62282";"   58394";"  298997";"   88737";"  129031";"   81229";"    8776";"       0";"       0"
"Amsterdam Airport Schiphol";"1999 February";"   28302";"     550";"   13760";"   13047";"     713";"   13766";"   13033";"     733";" 1157235";" 1076915";"   80320";" 1175429";" 1087675";"   87754";" 2332664";" 1534949";" 1299095";"  235854";"  797715";"  107207";"   45879";"   20988";"       0";"   20581";"   19759";"  408987";"  301060";"   57645";"   50282";"  274295";"   82654";"  110775";"   80866";"    7226";"       0";"       0"
"Amsterdam Airport Schiphol";"1999 March";"   32595";"     784";"   15745";"   14878";"     867";"   15728";"   14868";"     860";" 1418232";" 1323412";"   94820";" 1407096";" 1309286";"   97810";" 2825328";" 1837844";" 1558660";"  279184";"  987484";"  117193";"   53063";"   22334";"       0";"   20775";"   21021";"  531834";"  418994";"   59761";"   53079";"  330139";"  105905";"  120094";"  104140";"    8318";"       0";"       0"
"Amsterdam Airport Schiphol";"1999 April";"   33069";"     858";"   15999";"   14914";"    1085";"   16014";"   14920";"    1094";" 1430660";" 1316088";"  114572";" 1470818";" 1325753";"  145065";" 2901478";" 1926831";" 1636049";"  290782";"  974647";"  111309";"   51800";"   21994";"      71";"   17873";"   19571";"  524706";"  427737";"   51104";"   45865";"  331128";"  114182";"  109316";"  107630";"    7504";"       0";"       0"
"Amsterdam Airport Schiphol";"1999 May";"   35221";"     732";"   17070";"   15369";"    1701";"   17063";"   15374";"    1689";" 1635931";" 1397979";"  237952";" 1628024";" 1370713";"  257311";" 3263955";" 2231219";" 1881899";"  349320";" 1032736";"  111085";"   50951";"   21314";"       0";"   20057";"   18763";"  588521";"  487429";"   52679";"   48413";"  326257";"  112851";"  105889";"  107517";"    6873";"       0";"       0"
"Amsterdam Airport Schiphol";"1999 June";"   34707";"     828";"   16715";"   15195";"    1520";"   16711";"   15196";"    1515";" 1595150";" 1391589";"  203561";" 1631588";" 1401887";"  229701";" 3226738";" 2179958";" 1819314";"  360644";" 1046780";"  110111";"   44648";"   21736";"       0";"   24634";"   19093";"  614953";"  512995";"   49251";"   52707";"  314288";"  106125";"  101899";"  106264";"    7428";"       0";"       0"
"Amsterdam Airport Schiphol";"1999 July";"   36589";"     832";"   17754";"   15763";"    1991";"   17775";"   15777";"    1998";" 1693176";" 1420736";"  272440";" 1917610";" 1541110";"  376500";" 3610786";" 2420422";" 1974481";"  445941";" 1190364";"  145286";"   68439";"   27096";"       0";"   29206";"   20545";"  670512";"  538704";"   63558";"   68250";"  365967";"  128138";"  116167";"  121662";"    8599";"       0";"       0"
"Amsterdam Airport Schiphol";"1999 August";"   36485";"     678";"   17818";"   15773";"    2045";"   17807";"   15745";"    2062";" 1937342";" 1549037";"  388305";" 1771932";" 1456064";"  315868";" 3709274";" 2461637";" 2003578";"  458059";" 1247637";"  150400";"   71232";"   28745";"       0";"   29125";"   21298";"  692770";"  554157";"   66641";"   71972";"  395456";"  150219";"  123020";"  122217";"    9011";"       0";"       0"
"Amsterdam Airport Schiphol";"1999 September";"   35656";"     726";"   17203";"   15515";"    1688";"   17208";"   15510";"    1698";" 1742014";" 1472698";"  269316";" 1725171";" 1481186";"  243985";" 3467185";" 2340328";" 1964517";"  375811";" 1126857";"  134339";"   60075";"   25833";"       0";"   26909";"   21522";"  634140";"  512282";"   56997";"   64861";"  350160";"  121234";"  111050";"  117876";"    8218";"       0";"       0"
"Amsterdam Airport Schiphol";"1999 October";"   36292";"     620";"   17566";"   15994";"    1572";"   17560";"   15997";"    1563";" 1738734";" 1495431";"  243303";" 1710912";" 1506628";"  204284";" 3449646";" 2300568";" 1918892";"  381676";" 1149078";"  137098";"   64478";"   22941";"       0";"   27628";"   22051";"  628633";"  501679";"   62796";"   64158";"  374954";"  134680";"  122041";"  118233";"    8393";"       0";"       0"
"Amsterdam Airport Schiphol";"1999 November";"   34169";"     622";"   16596";"   15757";"     839";"   16586";"   15763";"     823";" 1415707";" 1320568";"   95139";" 1387244";" 1303652";"   83592";" 2802951";" 1819948";" 1534115";"  285833";"  983003";"  123495";"   54467";"   23361";"       0";"   23166";"   22501";"  515870";"  394949";"   65438";"   55483";"  335969";"  105347";"  132419";"   98203";"    7669";"       0";"       0"
"Amsterdam Airport Schiphol";"1999 December";"   32288";"     548";"   15799";"   15040";"     759";"   15722";"   14974";"     748";" 1229667";" 1165743";"   63924";" 1232863";" 1168361";"   64502";" 2462530";" 1584168";" 1321947";"  262221";"  878362";"  111273";"   40756";"   25924";"     113";"   24003";"   20477";"  464360";"  351598";"   63871";"   48891";"  295176";"   92084";"  119712";"   83380";"    7553";"       0";"       0"
"Amsterdam Airport Schiphol";"2000 January";"   33358";"     288";"   16229";"   15491";"     738";"   16308";"   15585";"     723";" 1243881";" 1170076";"   73805";" 1246764";" 1172346";"   74418";" 2490645";" 1582157";" 1317313";"  264844";"  908488";"  117626";"   44185";"   25839";"       0";"   25967";"   21635";"  468432";"  349329";"   66030";"   53073";"  314367";"   91217";"  135072";"   88078";"    8063";"       0";"       0"
"Amsterdam Airport Schiphol";"2000 February";"   32989";"     304";"   15951";"   15216";"     735";"   15943";"   15219";"     724";" 1251605";" 1177679";"   73926";" 1309915";" 1223629";"   86286";" 2561520";" 1675373";" 1410946";"  264427";"  886147";"  119506";"   49765";"   20957";"       0";"   28116";"   20668";"  444379";"  328231";"   64948";"   51200";"  314424";"   91834";"  130297";"   92293";"    7838";"       0";"       0"
"Amsterdam Airport Schiphol";"2000 March";"   35420";"     273";"   17127";"   16224";"     903";"   17136";"   16231";"     905";" 1557499";" 1445451";"  112048";" 1510055";" 1400930";"  109125";" 3067554";" 2017959";" 1687684";"  330275";" 1049595";"  131527";"   63162";"   22197";"       0";"   24842";"   21326";"  555392";"  432298";"   65897";"   57197";"  354650";"  114210";"  132135";"  108305";"    8026";"       0";"       0"
"Amsterdam Airport Schiphol";"2000 April";"   35030";"     342";"   16906";"   15667";"    1239";"   16909";"   15680";"    1229";" 1582875";" 1448837";"  134038";" 1644076";" 1463744";"  180332";" 3226951";" 2142676";" 1777869";"  364807";" 1084275";"  129266";"   61816";"   23761";"       0";"   23023";"   20666";"  575714";"  462896";"   58643";"   54175";"  371629";"  129843";"  124354";"  117432";"    7666";"       0";"       0"
"Amsterdam Airport Schiphol";"2000 May";"   37911";"     412";"   18276";"   16500";"    1776";"   18263";"   16494";"    1769";" 1768981";" 1524167";"  244814";" 1777512";" 1519384";"  258128";" 3546493";" 2441992";" 2009697";"  432295";" 1104501";"  117623";"   53218";"   23104";"       0";"   21799";"   19502";"  623217";"  516326";"   56380";"   50511";"  355685";"  122579";"  113051";"  120055";"    7976";"       0";"       0"
"Amsterdam Airport Schiphol";"2000 June";"   36727";"     308";"   17603";"   15951";"    1652";"   17603";"   15951";"    1652";" 1748085";" 1500882";"  247203";" 1744702";" 1485725";"  258977";" 3492787";" 2373124";" 1923068";"  450056";" 1119663";"  118334";"   47572";"   24193";"       0";"   27833";"   18736";"  655471";"  545320";"   57187";"   52964";"  339040";"  110585";"  110128";"  118327";"    6818";"       0";"       0"
"Amsterdam Airport Schiphol";"2000 July";"   38287";"     338";"   18553";"   16378";"    2175";"   18555";"   16385";"    2170";" 1856012";" 1540423";"  315589";" 2096251";" 1677969";"  418282";" 3952263";" 2674616";" 2134416";"  540200";" 1277647";"  152630";"   66488";"   30173";"       0";"   34798";"   21171";"  714381";"  575286";"   67789";"   71306";"  403142";"  141439";"  125555";"  136148";"    7494";"       0";"       0"
"Amsterdam Airport Schiphol";"2000 August";"   38300";"     388";"   18626";"   16436";"    2190";"   18632";"   16440";"    2192";" 2060959";" 1646689";"  414270";" 1871113";" 1538489";"  332624";" 3932072";" 2648907";" 2110330";"  538577";" 1283165";"  162638";"   73959";"   30327";"       0";"   37520";"   20832";"  702802";"  562749";"   66755";"   73298";"  409908";"  150100";"  127893";"  131915";"    7817";"       0";"       0"
"Amsterdam Airport Schiphol";"2000 September";"   36788";"     309";"   17752";"   15915";"    1837";"   17744";"   15931";"    1813";" 1857698";" 1565323";"  292375";" 1862586";" 1574520";"  288066";" 3720284";" 2533364";" 2065190";"  468174";" 1186920";"  148315";"   64804";"   28002";"       0";"   35140";"   20369";"  650945";"  527122";"   59118";"   64705";"  380381";"  126136";"  121304";"  132941";"    7279";"       0";"       0"
"Amsterdam Airport Schiphol";"2000 October";"   37315";"     253";"   18087";"   16350";"    1737";"   18083";"   16339";"    1744";" 1857661";" 1578422";"  279239";" 1793894";" 1568480";"  225414";" 3651555";" 2475461";" 2014934";"  460527";" 1176094";"  152229";"   68710";"   26308";"       0";"   36218";"   20993";"  620993";"  495824";"   60822";"   64347";"  394934";"  129359";"  132597";"  132978";"    7938";"       0";"       0"
"Amsterdam Airport Schiphol";"2000 November";"   34018";"     310";"   16455";"   15607";"     848";"   16447";"   15615";"     832";" 1467988";" 1369479";"   98509";" 1446984";" 1358877";"   88107";" 2914972";" 1901315";" 1581188";"  320127";" 1013657";"  135438";"   56348";"   25355";"       0";"   32104";"   21631";"  521696";"  398413";"   64304";"   58979";"  348726";"   96316";"  142380";"  110030";"    7797";"       0";"       0"
"Amsterdam Airport Schiphol";"2000 December";"   32546";"     245";"   15874";"   15020";"     854";"   15865";"   15022";"     843";" 1326896";" 1247741";"   79155";" 1386618";" 1297174";"   89444";" 2713514";" 1731137";" 1431939";"  299198";"  982377";"  130309";"   46088";"   27859";"       0";"   35461";"   20901";"  505127";"  373751";"   67570";"   63806";"  338342";"   92897";"  140959";"  104486";"    8599";"       0";"       0"
"Amsterdam Airport Schiphol";"2001 January";"   33669";"     282";"   16416";"   15606";"     810";"   16419";"   15606";"     813";" 1372944";" 1290819";"   82125";" 1331053";" 1253833";"   77220";" 2703997";" 1706476";" 1418968";"  287508";"  997521";"  139257";"   52839";"   27249";"       0";"   37573";"   21596";"  495888";"  360595";"   71633";"   63660";"  353274";"   93247";"  156379";"  103648";"    9102";"       0";"       0"
"Amsterdam Airport Schiphol";"2001 February";"   31384";"     259";"   15219";"   14389";"     830";"   15217";"   14398";"     819";" 1267878";" 1188028";"   79850";" 1323495";" 1231084";"   92411";" 2591373";" 1698103";" 1417395";"  280708";"  893270";"  128834";"   52223";"   22648";"     338";"   35237";"   18388";"  432925";"  315078";"   64921";"   52926";"  324347";"   88845";"  139103";"   96399";"    7164";"       0";"       0"
"Amsterdam Airport Schiphol";"2001 March";"   35662";"     255";"   17261";"   16218";"    1043";"   17268";"   16215";"    1053";" 1606317";" 1483602";"  122715";" 1557431";" 1439315";"  118116";" 3163748";" 2078101";" 1710801";"  367300";" 1085647";"  145156";"   68269";"   25782";"       0";"   30774";"   20331";"  554418";"  424649";"   72997";"   56772";"  380875";"  118069";"  144062";"  118744";"    5198";"       0";"       0"
"Amsterdam Airport Schiphol";"2001 April";"   35132";"     314";"   17081";"   15830";"    1251";"   17070";"   15844";"    1226";" 1653479";" 1522618";"  130861";" 1701658";" 1531119";"  170539";" 3355137";" 2243954";" 1845993";"  397961";" 1111183";"  136403";"   59433";"   27434";"       0";"   27429";"   22107";"  598527";"  472190";"   65935";"   60402";"  376253";"  126038";"  135299";"  114916";"       0";"       0";"       0"
"Amsterdam Airport Schiphol";"2001 May";"   38467";"     409";"   18622";"   16802";"    1820";"   18633";"   16807";"    1826";" 1802284";" 1550481";"  251803";" 1811418";" 1534643";"  276775";" 3613702";" 2516386";" 2018074";"  498312";" 1097316";"  123465";"   53362";"   24597";"       0";"   25390";"   20116";"  618800";"  498546";"   63237";"   57017";"  355051";"  118043";"  122319";"  114689";"       0";"       0";"       0"
"Amsterdam Airport Schiphol";"2001 June";"   37382";"     277";"   18100";"   16360";"    1740";"   18109";"   16364";"    1745";" 1840121";" 1591618";"  248503";" 1846652";" 1580222";"  266430";" 3686773";" 2519289";" 2020261";"  499028";" 1167484";"  136514";"   49171";"   26719";"       0";"   38801";"   21823";"  660362";"  532896";"   63470";"   63996";"  370608";"  120532";"  125574";"  124502";"       0";"       0";"       0"
"Amsterdam Airport Schiphol";"2001 July";"   39373";"     328";"   19193";"   16982";"    2211";"   19193";"   16992";"    2201";" 1931531";" 1609079";"  322452";" 2167185";" 1749960";"  417225";" 4098716";" 2804259";" 2207429";"  596830";" 1294457";"  162892";"   66061";"   32038";"       0";"   42277";"   22516";"  691505";"  531701";"   80376";"   79428";"  440060";"  161025";"  145447";"  133588";"       0";"       0";"       0"
"Amsterdam Airport Schiphol";"2001 August";"   39329";"     309";"   19223";"   16995";"    2228";"   19228";"   16992";"    2236";" 2133641";" 1727518";"  406123";" 1929876";" 1594983";"  334893";" 4063517";" 2749663";" 2183373";"  566290";" 1313854";"  169015";"   73192";"   32888";"       0";"   40407";"   22528";"  689852";"  535342";"   75699";"   78811";"  454987";"  176035";"  144805";"  134147";"       0";"       0";"       0"
"Amsterdam Airport Schiphol";"2001 September";"   37418";"     269";"   18219";"   16321";"    1898";"   18213";"   16313";"    1900";" 1776240";" 1482290";"  293950";" 1775249";" 1486048";"  289201";" 3551489";" 2494721";" 1990813";"  503908";" 1056768";"  146581";"   56918";"   30426";"       0";"   36440";"   22797";"  537573";"  402137";"   65126";"   70310";"  372614";"  120716";"  126840";"  125058";"       0";"       0";"       0"
"Amsterdam Airport Schiphol";"2001 October";"   37554";"     316";"   18244";"   16509";"    1735";"   18242";"   16506";"    1736";" 1643771";" 1388243";"  255528";" 1582892";" 1373425";"  209467";" 3226663";" 2290737";" 1839589";"  451148";"  935926";"  144036";"   55715";"   27611";"       0";"   37410";"   23300";"  465976";"  334381";"   70863";"   60732";"  325914";"  102208";"  119984";"  103722";"       0";"       0";"       0"
"Amsterdam Airport Schiphol";"2001 November";"   32090";"     304";"   15532";"   14836";"     696";"   15527";"   14827";"     700";" 1334350";" 1259176";"   75174";" 1322492";" 1255180";"   67312";" 2656842";" 1831133";" 1535292";"  295841";"  825709";"  119551";"   35052";"   29530";"       0";"   30698";"   24271";"  419974";"  291684";"   70687";"   57603";"  286184";"   75795";"  121009";"   89380";"       0";"       0";"       0"
"Amsterdam Airport Schiphol";"2001 December";"   31022";"     252";"   15114";"   14451";"     663";"   15113";"   14451";"     662";" 1266484";" 1209481";"   57003";" 1331000";" 1264306";"   66694";" 2597484";" 1710139";" 1421090";"  289049";"  887345";"  126532";"   34304";"   32794";"      36";"   31620";"   27778";"  453844";"  314131";"   77028";"   62685";"  306969";"   88131";"  125785";"   93053";"       0";"       0";"       0"
"Amsterdam Airport Schiphol";"2002 January";"   31655";"     266";"   15409";"   14757";"     652";"   15426";"   14761";"     665";" 1304963";" 1242319";"   62644";" 1267436";" 1209153";"   58283";" 2572399";" 1658347";" 1385422";"  272925";"  914052";"  138824";"   39232";"   34819";"      71";"   35467";"   29235";"  448415";"  309836";"   76803";"   61776";"  326813";"   86132";"  140592";"  100089";"       0";"       0";"       0"
"Amsterdam Airport Schiphol";"2002 February";"   29298";"     260";"   14229";"   13547";"     682";"   14224";"   13549";"     675";" 1278061";" 1207176";"   70885";" 1318570";" 1236632";"   81938";" 2596631";" 1755008";" 1473719";"  281289";"  841623";"  135528";"   43252";"   30461";"      30";"   35035";"   26750";"  402249";"  279642";"   68276";"   54331";"  303846";"   83976";"  126986";"   92884";"       0";"       0";"       0"
"Amsterdam Airport Schiphol";"2002 March";"   33488";"     372";"   16175";"   15305";"     870";"   16190";"   15320";"     870";" 1592617";" 1495938";"   96679";" 1572608";" 1471314";"  101294";" 3165225";" 2127732";" 1765422";"  362310";" 1037493";"  157328";"   54815";"   35549";"       0";"   36257";"   30707";"  518028";"  381771";"   73719";"   62538";"  362137";"  107118";"  136231";"  118788";"       0";"       0";"       0"
"Amsterdam Airport Schiphol";"2002 April";"   34175";"     283";"   16558";"   15341";"    1217";"   16549";"   15337";"    1212";" 1601630";" 1484463";"  117167";" 1701515";" 1526491";"  175024";" 3303145";" 2312401";" 1880116";"  432285";"  990744";"  136071";"   49903";"   32906";"      70";"   25756";"   27436";"  507066";"  380914";"   68891";"   57261";"  347607";"  107360";"  123931";"  116316";"       0";"       0";"       0"
"Amsterdam Airport Schiphol";"2002 May";"   36835";"     347";"   17795";"   16038";"    1757";"   17804";"   16042";"    1762";" 1874934";" 1613973";"  260961";" 1823313";" 1557087";"  266226";" 3698247";" 2658970";" 2101262";"  557708";" 1039277";"  127942";"   45564";"   29553";"       0";"   27695";"   25130";"  563262";"  440105";"   70155";"   53002";"  348073";"  109342";"  120597";"  118134";"       0";"       0";"       0"
"Amsterdam Airport Schiphol";"2002 June";"   35744";"     355";"   17257";"   15608";"    1649";"   17262";"   15605";"    1657";" 1808523";" 1581431";"  227092";" 1860108";" 1605871";"  254237";" 3668631";" 2561913";" 2029698";"  532215";" 1106718";"  138219";"   43274";"   31905";"       0";"   36051";"   26989";"  608582";"  482385";"   68328";"   57869";"  359917";"  116337";"  118960";"  124620";"       0";"       0";"       0"
"Amsterdam Airport Schiphol";"2002 July";"   38056";"     297";"   18489";"   16403";"    2086";"   18484";"   16400";"    2084";" 1965535";" 1659676";"  305859";" 2164898";" 1775705";"  389193";" 4130433";" 2897866";" 2239649";"  658217";" 1232567";"  169150";"   63743";"   34353";"       0";"   42633";"   28421";"  656689";"  496550";"   88072";"   72067";"  406728";"  147451";"  132312";"  126965";"       0";"       0";"       0"
"Amsterdam Airport Schiphol";"2002 August";"   37560";"     349";"   18419";"   16275";"    2144";"   18421";"   16271";"    2150";" 2161757";" 1773642";"  388115";" 1969643";" 1651977";"  317666";" 4131400";" 2863699";" 2229055";"  634644";" 1267701";"  174621";"   64605";"   36526";"       0";"   41842";"   31648";"  665832";"  506747";"   83303";"   75782";"  427248";"  162856";"  132314";"  132078";"       0";"       0";"       0"
"Amsterdam Airport Schiphol";"2002 September";"   36214";"     302";"   17560";"   15822";"    1738";"   17551";"   15823";"    1728";" 1922853";" 1656533";"  266320";" 1941505";" 1668618";"  272887";" 3864358";" 2717046";" 2156418";"  560628";" 1147312";"  161988";"   53989";"   36978";"       0";"   39689";"   31332";"  605003";"  465062";"   72097";"   67844";"  380321";"  124270";"  125131";"  130920";"       0";"       0";"       0"
"Amsterdam Airport Schiphol";"2002 October";"   36788";"     269";"   17830";"   16098";"    1732";"   17833";"   16090";"    1743";" 1890032";" 1623337";"  266695";" 1831078";" 1616539";"  214539";" 3721110";" 2599838";" 2040262";"  559576";" 1121272";"  168404";"   63519";"   32987";"       0";"   39648";"   32250";"  584454";"  448017";"   74999";"   61438";"  368414";"  114685";"  129357";"  124372";"       0";"       0";"       0"
"Amsterdam Airport Schiphol";"2002 November";"   32685";"     286";"   15836";"   15010";"     826";"   15834";"   15009";"     825";" 1455318";" 1375270";"   80048";" 1437214";" 1364394";"   72820";" 2892532";" 1932027";" 1601991";"  330036";"  960505";"  142981";"   45648";"   32183";"       0";"   33012";"   32138";"  493734";"  361689";"   75087";"   56958";"  323790";"   88766";"  125171";"  109853";"       0";"       0";"       0"
"Amsterdam Airport Schiphol";"2002 December";"   31046";"     181";"   15136";"   14346";"     790";"   15114";"   14332";"     782";" 1385381";" 1322303";"   63078";" 1458070";" 1382635";"   75435";" 2843451";" 1836464";" 1515717";"  320747";" 1006987";"  147694";"   46217";"   34950";"       0";"   35256";"   31271";"  528920";"  381431";"   81707";"   65782";"  330373";"  101238";"  126132";"  103003";"       0";"       0";"       0"
"Amsterdam Airport Schiphol";"2003 January";"   31342";"     309";"   15257";"   14547";"     710";"   15292";"   14567";"     725";" 1394786";" 1328372";"   66414";" 1352716";" 1288200";"   64516";" 2747502";" 1754994";" 1456223";"  298771";"  992508";"  150279";"   43014";"   35335";"       0";"   38330";"   33600";"  497324";"  352839";"   84739";"   59746";"  344905";"   97017";"  141969";"  105919";"       0";"       0";"       0"
"Amsterdam Airport Schiphol";"2003 February";"   29540";"     298";"   14392";"   13655";"     737";"   14388";"   13656";"     732";" 1310574";" 1244155";"   66419";" 1358201";" 1279486";"   78715";" 2668775";" 1794268";" 1499185";"  295083";"  874507";"  142411";"   49401";"   28910";"       0";"   33844";"   30256";"  430647";"  297485";"   78651";"   54511";"  301449";"   78301";"  125163";"   97985";"       0";"       0";"       0"
"Amsterdam Airport Schiphol";"2003 March";"   33536";"     379";"   16288";"   15379";"     909";"   16274";"   15369";"     905";" 1535286";" 1442485";"   92801";" 1483316";" 1395636";"   87680";" 3018602";" 2071769";" 1719513";"  352256";"  946833";"  139947";"   44571";"   31718";"       0";"   30848";"   32810";"  502530";"  363114";"   80353";"   59063";"  304356";"   72245";"  123682";"  108429";"       0";"       0";"       0"
"Amsterdam Airport Schiphol";"2003 April";"   32563";"     322";"   15786";"   14537";"    1249";"   15774";"   14549";"    1225";" 1455492";" 1361064";"   94428";" 1557900";" 1402801";"  155099";" 3013392";" 2156829";" 1773195";"  383634";"  856563";"  122968";"   39603";"   29125";"       0";"   24997";"   29243";"  482273";"  343541";"   82292";"   56440";"  251322";"   67458";"  107236";"   76628";"       0";"       0";"       0"
"Amsterdam Airport Schiphol";"2003 May";"   34976";"     366";"   16928";"   15189";"    1739";"   16968";"   15212";"    1756";" 1704497";" 1486279";"  218218";" 1689160";" 1458103";"  231057";" 3393657";" 2490478";" 1989496";"  500982";"  903179";"  119544";"   38327";"   29135";"       0";"   27063";"   25019";"  532927";"  399423";"   76814";"   56690";"  250708";"   91223";"   98317";"   61168";"       0";"       0";"       0"
"Amsterdam Airport Schiphol";"2003 June";"   34593";"     325";"   16765";"   15127";"    1638";"   16746";"   15134";"    1612";" 1745817";" 1544473";"  201344";" 1798416";" 1568515";"  229901";" 3544233";" 2548756";" 2012930";"  535826";"  995477";"  125626";"   39280";"   28498";"       0";"   33706";"   24142";"  582663";"  441600";"   81841";"   59222";"  287188";"  102463";"  108755";"   75970";"       0";"       0";"       0"
"Amsterdam Airport Schiphol";"2003 July";"   36914";"     311";"   18012";"   15679";"    2333";"   18024";"   15709";"    2315";" 1933355";" 1618691";"  314664";" 2142477";" 1740068";"  402409";" 4075832";" 2886991";" 2198323";"  688668";" 1188841";"  162577";"   61965";"   33234";"     555";"   38581";"   28242";"  656145";"  472350";"  108125";"   75670";"  370119";"  135418";"  135619";"   99082";"       0";"       0";"       0"
"Amsterdam Airport Schiphol";"2003 August";"   36528";"     391";"   17863";"   15613";"    2250";"   17859";"   15629";"    2230";" 2130647";" 1760113";"  370534";" 1902276";" 1626945";"  275331";" 4032923";" 2797706";" 2152493";"  645213";" 1235217";"  172482";"   64002";"   36735";"    2393";"   39666";"   29686";"  651163";"  474121";"   98528";"   78514";"  411572";"  150506";"  135336";"  125730";"       0";"       0";"       0"
"Amsterdam Airport Schiphol";"2003 September";"   35593";"     385";"   17253";"   15543";"    1710";"   17255";"   15558";"    1697";" 1852305";" 1628733";"  223572";" 1882204";" 1648310";"  233894";" 3734509";" 2628432";" 2060094";"  568338";" 1106077";"  156171";"   51583";"   35883";"    2567";"   35703";"   30435";"  585688";"  439311";"   80868";"   65509";"  364218";"  115434";"  118291";"  130493";"       0";"       0";"       0"
"Amsterdam Airport Schiphol";"2003 October";"   36245";"     349";"   17551";"   15729";"    1822";"   17557";"   15783";"    1774";" 1908245";" 1651331";"  256914";" 1853040";" 1640709";"  212331";" 3761285";" 2631320";" 2040890";"  590430";" 1129965";"  168751";"   60785";"   34661";"    2446";"   36531";"   34328";"  583304";"  424828";"   94411";"   64065";"  377910";"  119958";"  127331";"  130621";"       0";"       0";"       0"
"Amsterdam Airport Schiphol";"2003 November";"   32034";"     213";"   15531";"   14536";"     995";"   15523";"   14575";"     948";" 1489005";" 1397754";"   91251";" 1481085";" 1397087";"   83998";" 2970090";" 1980956";" 1613544";"  367412";"  989134";"  148179";"   46413";"   31949";"    2248";"   32403";"   35166";"  510367";"  352230";"   95622";"   62515";"  330588";"   91866";"  127464";"  111258";"       0";"       0";"       0"
"Amsterdam Airport Schiphol";"2003 December";"   30512";"     256";"   14886";"   13937";"     949";"   14824";"   13912";"     912";" 1389921";" 1315777";"   74144";" 1457928";" 1364687";"   93241";" 2847849";" 1835351";" 1491893";"  343458";" 1012498";"  154311";"   51252";"   32719";"    2751";"   35619";"   31970";"  524144";"  356309";"  103736";"   64099";"  334043";"  102219";"  131792";"  100032";"       0";"       0";"       0"
"Amsterdam Airport Schiphol";"2004 January";"   30477";"     233";"   14849";"   13967";"     882";"   14913";"   14046";"     867";" 1386421";" 1296366";"   90055";" 1355259";" 1270518";"   84741";" 2741680";" 1712817";" 1394292";"  318525";" 1028863";"  166803";"   51686";"   35348";"    2759";"   41531";"   35479";"  511108";"  339284";"  104160";"   67664";"  350952";"  100198";"  146496";"  104258";"       0";"       0";"       0"
"Amsterdam Airport Schiphol";"2004 February";"   30155";"     235";"   14681";"   13754";"     927";"   14680";"   13784";"     896";" 1394302";" 1303888";"   90414";" 1436337";" 1338263";"   98074";" 2830639";" 1871583";" 1532901";"  338682";"  959056";"  164352";"   55753";"   31753";"    2093";"   40220";"   34533";"  461663";"  304170";"   92886";"   64607";"  333041";"   93775";"  133151";"  106115";"       0";"       0";"       0"
"Amsterdam Airport Schiphol";"2004 March";"   33791";"     326";"   16366";"   15335";"    1031";"   16360";"   15349";"    1011";" 1656357";" 1549929";"  106428";" 1601316";" 1498619";"  102697";" 3257673";" 2172871";" 1774559";"  398312";" 1084802";"  169161";"   60773";"   34023";"    2382";"   35950";"   36033";"  552050";"  391921";"   94883";"   65246";"  363591";"  108120";"  134139";"  121332";"       0";"       0";"       0"
"Amsterdam Airport Schiphol";"2004 April";"   33695";"     368";"   16335";"   15110";"    1225";"   16343";"   15115";"    1228";" 1693564";" 1580663";"  112901";" 1786521";" 1626498";"  160023";" 3480085";" 2380283";" 1902359";"  477924";" 1099802";"  149863";"   57955";"   33092";"    2794";"   27336";"   28686";"  580724";"  431104";"   88250";"   61370";"  369215";"  119625";"  123333";"  126257";"       0";"       0";"       0"
"Amsterdam Airport Schiphol";"2004 May";"   36903";"     372";"   17851";"   15883";"    1968";"   17846";"   15888";"    1958";" 1932881";" 1674436";"  258445";" 1910390";" 1644988";"  265402";" 3843271";" 2729841";" 2091874";"  637967";" 1113430";"  137540";"   53496";"   30766";"    2800";"   27247";"   23231";"  615433";"  467876";"   88431";"   59126";"  360457";"  114456";"  118529";"  127472";"       0";"       0";"       0"
"Amsterdam Airport Schiphol";"2004 June";"   36061";"     345";"   17426";"   15721";"    1705";"   17439";"   15722";"    1717";" 1893565";" 1685573";"  207992";" 1903396";" 1684197";"  219199";" 3796961";" 2662991";" 2073742";"  589249";" 1133970";"  136168";"   41989";"   29629";"    2892";"   38362";"   23296";"  623784";"  485477";"   82603";"   55704";"  374018";"  118316";"  121015";"  134687";"       0";"       0";"       0"
"Amsterdam Airport Schiphol";"2004 July";"   37832";"     329";"   18449";"   16289";"    2160";"   18463";"   16279";"    2184";" 2033995";" 1739916";"  294079";" 2303772";" 1915466";"  388306";" 4337767";" 3039462";" 2253947";"  785515";" 1298305";"  187039";"   70248";"   35190";"    3440";"   49518";"   28643";"  679539";"  508639";"  100687";"   70213";"  431727";"  141364";"  143510";"  146853";"       0";"       0";"       0"
"Amsterdam Airport Schiphol";"2004 August";"   37520";"     315";"   18353";"   16196";"    2157";"   18343";"   16178";"    2165";" 2223513";" 1863115";"  360398";" 2020117";" 1726780";"  293337";" 4243630";" 2935092";" 2222331";"  712761";" 1308538";"  192101";"   73468";"   37107";"    3059";"   49470";"   28997";"  677807";"  505707";"  102213";"   69887";"  438630";"  150597";"  141111";"  146922";"       0";"       0";"       0"
"Amsterdam Airport Schiphol";"2004 September";"   36625";"     350";"   17671";"   16018";"    1653";"   17659";"   16006";"    1653";" 1954521";" 1729471";"  225050";" 1972681";" 1742827";"  229854";" 3927202";" 2731010";" 2109650";"  621360";" 1196192";"  177377";"   63196";"   34731";"    3230";"   46984";"   29236";"  624841";"  471966";"   86177";"   66698";"  393974";"  118199";"  124670";"  151105";"       0";"       0";"       0"
"Amsterdam Airport Schiphol";"2004 October";"   37678";"     364";"   18242";"   16283";"    1959";"   18239";"   16281";"    1958";" 1979928";" 1712464";"  267464";" 1935368";" 1709027";"  226341";" 3915296";" 2714635";" 2053667";"  660968";" 1200661";"  185928";"   71049";"   33769";"    2400";"   47036";"   31674";"  613923";"  452577";"   93447";"   67899";"  400810";"  116294";"  132466";"  152050";"       0";"       0";"       0"
"Amsterdam Airport Schiphol";"2004 November";"   32627";"     270";"   15828";"   14870";"     958";"   15818";"   14888";"     930";" 1545102";" 1457545";"   87557";" 1542294";" 1462727";"   79567";" 3087396";" 2017426";" 1625522";"  391904";" 1069970";"  166456";"   53543";"   36190";"    1004";"   38541";"   37178";"  532964";"  381602";"   91192";"   60170";"  370550";"   92920";"  146895";"  130735";"       0";"       0";"       0"
"Amsterdam Airport Schiphol";"2004 December";"   31534";"     207";"   15319";"   14375";"     944";"   15265";"   14344";"     921";" 1445136";" 1383700";"   61436";" 1518656";" 1437612";"   81044";" 2963792";" 1866050";" 1500622";"  365428";" 1097742";"  168605";"   50686";"   40625";"    1205";"   39581";"   36508";"  556277";"  398678";"   93209";"   64390";"  372860";"  102584";"  152514";"  117762";"       0";"       0";"       0"
"Amsterdam Airport Schiphol";"2005 January";"   31259";"     258";"   15147";"   14194";"     953";"   15206";"   14240";"     966";" 1488217";" 1397930";"   90287";" 1467575";" 1379619";"   87956";" 2955792";" 1826971";" 1544187";"  282784";" 1128821";"  181467";"   56737";"   41176";"     977";"   46227";"   36350";"  555620";"  379849";"  105111";"   70660";"  391734";"   93044";"  173174";"  125516";"       0";"       0";"       0"
"Amsterdam Airport Schiphol";"2005 February";"   29473";"     235";"   14289";"   13312";"     977";"   14290";"   13324";"     966";" 1407350";" 1322565";"   84785";" 1422575";" 1332806";"   89769";" 2829925";" 1829433";" 1562169";"  267264";" 1000492";"  170360";"   57265";"   34716";"     754";"   44141";"   33484";"  486368";"  329740";"   93707";"   62921";"  343764";"   81494";"  146612";"  115658";"       0";"       0";"       0"
"Amsterdam Airport Schiphol";"2005 March";"   32777";"     238";"   15912";"   14851";"    1061";"   15915";"   14868";"    1047";" 1646577";" 1554196";"   92381";" 1634618";" 1541041";"   93577";" 3281195";" 2137360";" 1817173";"  320187";" 1143835";"  188169";"   65889";"   40515";"    1038";"   43557";"   37170";"  578847";"  422085";"   93632";"   63130";"  376819";"   97613";"  145925";"  133281";"       0";"       0";"       0"
"Amsterdam Airport Schiphol";"2005 April";"   34906";"     264";"   16862";"   15651";"    1211";"   16877";"   15670";"    1207";" 1735488";" 1641284";"   94204";" 1812523";" 1666741";"  145782";" 3548011";" 2388567";" 2000129";"  388438";" 1159444";"  172259";"   68467";"   39327";"    1000";"   32880";"   30585";"  595823";"  452401";"   83728";"   59694";"  391362";"  105003";"  141301";"  145058";"       0";"       0";"       0"
"Amsterdam Airport Schiphol";"2005 May";"   37799";"     304";"   18344";"   16380";"    1964";"   18329";"   16375";"    1954";" 2027863";" 1768023";"  259840";" 2031785";" 1761275";"  270510";" 4059648";" 2867159";" 2278939";"  588220";" 1192489";"  166992";"   70824";"   36648";"     688";"   32840";"   25992";"  645783";"  501468";"   88225";"   56090";"  379714";"  105519";"  129437";"  144758";"       0";"       0";"       0"
"Amsterdam Airport Schiphol";"2005 June";"   36606";"     319";"   17622";"   16062";"    1560";"   17617";"   16061";"    1556";" 1952478";" 1758384";"  194094";" 1988697";" 1781268";"  207429";" 3941175";" 2724670";" 2223836";"  500834";" 1216505";"  166320";"   55652";"   34825";"     850";"   47640";"   27353";"  663236";"  519154";"   85803";"   58279";"  386949";"  105792";"  131961";"  149196";"       0";"       0";"       0"
"Amsterdam Airport Schiphol";"2005 July";"   38212";"     350";"   18620";"   16408";"    2212";"   18636";"   16427";"    2209";" 2122109";" 1835188";"  286921";" 2406485";" 2010922";"  395563";" 4528594";" 3134037";" 2450487";"  683550";" 1394557";"  216677";"   87714";"   39938";"     914";"   56048";"   32063";"  731989";"  552955";"  103862";"   75172";"  445891";"  130270";"  154843";"  160778";"       0";"       0";"       0"
"Amsterdam Airport Schiphol";"2005 August";"   38182";"     411";"   18647";"   16483";"    2164";"   18635";"   16478";"    2157";" 2319924";" 1955626";"  364298";" 2113227";" 1823117";"  290110";" 4433151";" 3050034";" 2418509";"  631525";" 1383117";"  220048";"   86721";"   42037";"     945";"   56961";"   33384";"  719438";"  538359";"  103791";"   77288";"  443631";"  132309";"  152567";"  158755";"       0";"       0";"       0"
"Amsterdam Airport Schiphol";"2005 September";"   36881";"     293";"   17861";"   16161";"    1700";"   17851";"   16155";"    1696";" 2069173";" 1840241";"  228932";" 2076564";" 1848891";"  227673";" 4145737";" 2875493";" 2361466";"  514027";" 1270244";"  194959";"   69438";"   38216";"     915";"   54144";"   32246";"  659116";"  505014";"   81827";"   72275";"  416169";"  109975";"  143016";"  163178";"       0";"       0";"       0"
"Amsterdam Airport Schiphol";"2005 October";"   37503";"     314";"   18166";"   16323";"    1843";"   18155";"   16307";"    1848";" 2064136";" 1802536";"  261600";" 2012996";" 1793949";"  219047";" 4077132";" 2848214";" 2291154";"  557060";" 1228918";"  197728";"   72472";"   34312";"     731";"   55466";"   34747";"  627559";"  461448";"   95026";"   71085";"  403631";"   99092";"  148304";"  156235";"       0";"       0";"       0"
"Amsterdam Airport Schiphol";"2005 November";"   32582";"     258";"   15736";"   14920";"     816";"   15746";"   14941";"     805";" 1594271";" 1525042";"   69229";" 1604248";" 1539658";"   64590";" 3198519";" 2097811";" 1802558";"  295253";" 1100708";"  179056";"   61303";"   33761";"       0";"   47774";"   36218";"  535889";"  378350";"   90448";"   67091";"  385763";"   96394";"  151088";"  138281";"       0";"       0";"       0"
"Amsterdam Airport Schiphol";"2005 December";"   31084";"     225";"   15089";"   14265";"     824";"   15042";"   14244";"     798";" 1499625";" 1442630";"   56995";" 1579035";" 1507671";"   71364";" 3078660";" 1966719";" 1682176";"  284543";" 1111941";"  181502";"   56084";"   37426";"       0";"   51333";"   36659";"  546925";"  383406";"   95141";"   68378";"  383514";"  102483";"  157100";"  123931";"       0";"       0";"       0"
"Amsterdam Airport Schiphol";"2006 January";"   31271";"     254";"   15130";"   14304";"     826";"   15169";"   14356";"     813";" 1529682";" 1451489";"   78193";" 1498525";" 1427755";"   70770";" 3028207";" 1887313";" 1603742";"  283571";" 1140894";"  193679";"   60089";"   36244";"      50";"   59218";"   38078";"  544084";"  371176";"  103180";"   69728";"  403131";"   96590";"  177102";"  129439";"       0";"       0";"       0"
"Amsterdam Airport Schiphol";"2006 February";"   29164";"     253";"   14201";"   13383";"     818";"   14202";"   13405";"     797";" 1408888";" 1336772";"   72116";" 1449556";" 1370016";"   79540";" 2858444";" 1864229";" 1605571";"  258658";"  994215";"  173797";"   56900";"   28553";"     191";"   53841";"   34312";"  458786";"  305549";"   93141";"   60096";"  361632";"   81566";"  157869";"  122197";"       0";"       0";"       0"
"Amsterdam Airport Schiphol";"2006 March";"   34129";"     287";"   16522";"   15664";"     858";"   16522";"   15713";"     809";" 1715453";" 1631041";"   84412";" 1683862";" 1601050";"   82812";" 3399315";" 2226476";" 1910755";"  315721";" 1172839";"  189198";"   70004";"   34572";"       0";"   49842";"   34780";"  570315";"  413688";"   93030";"   63597";"  413326";"  103862";"  163665";"  145799";"       0";"       0";"       0"
"Amsterdam Airport Schiphol";"2006 April";"   35799";"     261";"   17345";"   16201";"    1144";"   17353";"   16206";"    1147";" 1861980";" 1762720";"   99260";" 1947014";" 1797660";"  149354";" 3808994";" 2588631";" 2202036";"  386595";" 1220363";"  183725";"   75665";"   36065";"       0";"   42023";"   29972";"  609319";"  456343";"   92206";"   60770";"  427319";"  116177";"  160960";"  150182";"       0";"       0";"       0"
"Amsterdam Airport Schiphol";"2006 May";"   39444";"     362";"   19075";"   17110";"    1965";"   19071";"   17111";"    1960";" 2091783";" 1843832";"  247951";" 2084314";" 1825786";"  258528";" 4176097";" 2962123";" 2470933";"  491190";" 1213974";"  172949";"   72715";"   35739";"       0";"   40764";"   23731";"  636673";"  494110";"   84570";"   57993";"  404352";"  102963";"  149916";"  151473";"       0";"       0";"       0"
"Amsterdam Airport Schiphol";"2006 June";"   38852";"     346";"   18761";"   16900";"    1861";"   18765";"   16905";"    1860";" 2110234";" 1876366";"  233868";" 2118093";" 1874874";"  243219";" 4228327";" 2965843";" 2479775";"  486068";" 1262484";"  178628";"   62467";"   35921";"       0";"   55109";"   25131";"  663559";"  514221";"   87709";"   61629";"  420297";"  111953";"  154966";"  153378";"       0";"       0";"       0"
"Amsterdam Airport Schiphol";"2006 July";"   40336";"     388";"   19649";"   17151";"    2498";"   19641";"   17169";"    2472";" 2219591";" 1908437";"  311154";" 2524848";" 2103319";"  421529";" 4744439";" 3331417";" 2696275";"  635142";" 1413022";"  240440";"   98422";"   43031";"       0";"   70373";"   28614";"  710651";"  535846";"  100061";"   74744";"  461931";"  129971";"  169610";"  162350";"       0";"       0";"       0"
"Amsterdam Airport Schiphol";"2006 August";"   40077";"     346";"   19516";"   17214";"    2302";"   19520";"   17169";"    2351";" 2417135";" 2038500";"  378635";" 2191035";" 1886096";"  304939";" 4608170";" 3198583";" 2585910";"  612673";" 1409587";"  246900";"  100216";"   43530";"       0";"   70031";"   33123";"  695525";"  524341";"   97700";"   73484";"  467162";"  136930";"  165451";"  164781";"       0";"       0";"       0"
"Amsterdam Airport Schiphol";"2006 September";"   38804";"     363";"   18760";"   16854";"    1906";"   18761";"   16845";"    1916";" 2151366";" 1897312";"  254054";" 2144008";" 1894479";"  249529";" 4295374";" 3002208";" 2508833";"  493375";" 1293166";"  209745";"   74456";"   38866";"     127";"   62423";"   33873";"  650258";"  496520";"   84030";"   69708";"  433163";"  102557";"  158376";"  172230";"       0";"       0";"       0"
"Amsterdam Airport Schiphol";"2006 October";"   39598";"     404";"   19212";"   17508";"    1704";"   19201";"   17551";"    1650";" 2118890";" 1901265";"  217625";" 2082583";" 1906920";"  175663";" 4201473";" 2921557";" 2430627";"  490930";" 1279916";"  214466";"   78382";"   37239";"      48";"   62878";"   35919";"  635102";"  472517";"   92210";"   70375";"  430348";"   97587";"  163162";"  169599";"       0";"       0";"       0"
"Amsterdam Airport Schiphol";"2006 November";"   35503";"     333";"   17187";"   16379";"     808";"   17159";"   16398";"     761";" 1683436";" 1613516";"   69920";" 1669839";" 1608340";"   61499";" 3353275";" 2229054";" 1917284";"  311770";" 1124221";"  190935";"   65241";"   35410";"     203";"   53484";"   36597";"  541302";"  377671";"   95049";"   68582";"  391984";"   85526";"  160249";"  146209";"       0";"       0";"       0"
"Amsterdam Airport Schiphol";"2006 December";"   33289";"     292";"   16216";"   15370";"     846";"   16184";"   15355";"     829";" 1598572";" 1540616";"   57956";" 1688279";" 1615553";"   72726";" 3286851";" 2109827";" 1797342";"  312485";" 1177024";"  198321";"   61150";"   41684";"      17";"   56837";"   38633";"  579243";"  398913";"  105227";"   75103";"  399460";"   96980";"  168906";"  133574";"       0";"       0";"       0"
"Amsterdam Airport Schiphol";"2007 January";"   33704";"     289";"   16326";"   15573";"     753";"   16360";"   15614";"     746";" 1615134";" 1546999";"   68135";" 1554755";" 1497869";"   56886";" 3169889";" 1993371";" 1717250";"  276121";" 1176518";"  200760";"   57808";"   41838";"       0";"   63809";"   37305";"  563084";"  373849";"  110980";"   78255";"  412674";"   92990";"  185303";"  134381";"       0";"       0";"       0"
"Amsterdam Airport Schiphol";"2007 February";"   31910";"     322";"   15458";"   14690";"     768";"   15457";"   14715";"     742";" 1504093";" 1443731";"   60362";" 1547627";" 1479201";"   68426";" 3051720";" 2014433";" 1739752";"  274681";" 1037287";"  182851";"   60034";"   32248";"       0";"   56939";"   33630";"  483069";"  312404";"  102078";"   68587";"  371367";"   78374";"  163181";"  129812";"       0";"       0";"       0"
"Amsterdam Airport Schiphol";"2007 March";"   36626";"     381";"   17730";"   16785";"     945";"   17729";"   16809";"     920";" 1874996";" 1790082";"   84914";" 1820430";" 1738168";"   82262";" 3695426";" 2465479";" 2126631";"  338848";" 1229947";"  207091";"   77791";"   39857";"      20";"   53050";"   36373";"  597245";"  421201";"  105637";"   70407";"  425611";"   97588";"  170141";"  157882";"       0";"       0";"       0"
"Amsterdam Airport Schiphol";"2007 April";"   37247";"     470";"   18042";"   16881";"    1161";"   18037";"   16899";"    1138";" 1914054";" 1824473";"   89581";" 1991447";" 1860001";"  131446";" 3905501";" 2685778";" 2303151";"  382627";" 1219723";"  181934";"   74139";"   33425";"       0";"   43060";"   31310";"  613710";"  458489";"   88255";"   66966";"  424079";"  105707";"  157905";"  160467";"       0";"       0";"       0"
"Amsterdam Airport Schiphol";"2007 May";"   40732";"     403";"   19749";"   17819";"    1930";"   19760";"   17841";"    1919";" 2160655";" 1924632";"  236023";" 2135803";" 1890511";"  245292";" 4296458";" 3050454";" 2546505";"  503949";" 1246004";"  178246";"   80104";"   32127";"       0";"   41593";"   24422";"  660927";"  509286";"   85125";"   66516";"  406831";"  101127";"  144737";"  160967";"       0";"       0";"       0"
"Amsterdam Airport Schiphol";"2007 June";"   39390";"     364";"   19025";"   17380";"    1645";"   19029";"   17376";"    1653";" 2114293";" 1919559";"  194734";" 2131954";" 1926990";"  204964";" 4246247";" 2960451";" 2483605";"  476846";" 1285796";"  186269";"   71965";"   34546";"       0";"   54866";"   24892";"  674787";"  520445";"   86247";"   68095";"  424740";"  104531";"  153622";"  166587";"       0";"       0";"       0"
"Amsterdam Airport Schiphol";"2007 July";"   41739";"     358";"   20230";"   17793";"    2437";"   20234";"   17819";"    2415";" 2307792";" 2006510";"  301282";" 2614057";" 2215356";"  398701";" 4921849";" 3459722";" 2851437";"  608285";" 1462127";"  254729";"  108894";"   42756";"       0";"   74332";"   28747";"  740303";"  560612";"   97901";"   81790";"  467095";"  124426";"  169346";"  173323";"       0";"       0";"       0"
"Amsterdam Airport Schiphol";"2007 August";"   41107";"     458";"   20070";"   17681";"    2389";"   20066";"   17686";"    2380";" 2543312";" 2161300";"  382012";" 2278134";" 1977870";"  300264";" 4821446";" 3350716";" 2778350";"  572366";" 1470730";"  255969";"  109232";"   45687";"       0";"   73802";"   27248";"  739100";"  560496";"   95940";"   82664";"  475661";"  136961";"  163187";"  175513";"       0";"       0";"       0"
"Amsterdam Airport Schiphol";"2007 September";"   39108";"     393";"   18911";"   17175";"    1736";"   18921";"   17186";"    1735";" 2211075";" 1979858";"  231217";" 2213989";" 1986374";"  227615";" 4425064";" 3086664";" 2594591";"  492073";" 1338400";"  216351";"   80700";"   41411";"       0";"   66095";"   28145";"  689846";"  528943";"   85608";"   75295";"  432203";"   97825";"  154270";"  180108";"       0";"       0";"       0"
"Amsterdam Airport Schiphol";"2007 October";"   39998";"     379";"   19331";"   17680";"    1651";"   19322";"   17677";"    1645";" 2213959";" 1990312";"  223647";" 2165140";" 1982711";"  182429";" 4379099";" 3027094";" 2529826";"  497268";" 1352005";"  225510";"   93869";"   36040";"     146";"   64709";"   30746";"  677302";"  508803";"   95032";"   73467";"  449193";"  106027";"  162681";"  180485";"       0";"       0";"       0"
"Amsterdam Airport Schiphol";"2007 November";"   35070";"     343";"   16945";"   16110";"     835";"   16941";"   16113";"     828";" 1745839";" 1676260";"   69579";" 1727050";" 1661897";"   65153";" 3472889";" 2288084";" 1974688";"  313396";" 1184805";"  202182";"   77512";"   37698";"      66";"   54440";"   32466";"  570558";"  411779";"   93149";"   65630";"  412065";"   93479";"  168019";"  150567";"       0";"       0";"       0"
"Amsterdam Airport Schiphol";"2007 December";"   33240";"     323";"   16170";"   15302";"     868";"   16129";"   15284";"     845";" 1644613";" 1581098";"   63515";" 1714547";" 1641602";"   72945";" 3359160";" 2134644";" 1835956";"  298688";" 1224516";"  206006";"   73209";"   41687";"      83";"   57036";"   33991";"  600910";"  433611";"   96450";"   70849";"  417600";"  107197";"  173206";"  137197";"       0";"       0";"       0"
"Amsterdam Airport Schiphol";"2008 January";"   33619";"     383";"   16224";"   15521";"     703";"   16295";"   15595";"     700";" 1625090";" 1560371";"   64719";" 1575854";" 1520060";"   55794";" 3200944";" 2002811";" 1710942";"  291869";" 1198133";"  201342";"   69324";"   42324";"       0";"   54403";"   35291";"  571163";"  391454";"  105610";"   74099";"  425628";"   94755";"  188743";"  142130";"       0";"       0";"       0"
"Amsterdam Airport Schiphol";"2008 February";"   32255";"     376";"   15608";"   14847";"     761";"   15605";"   14871";"     734";" 1559515";" 1498906";"   60609";" 1593655";" 1526881";"   66774";" 3153170";" 2070274";" 1778962";"  291312";" 1082896";"  187866";"   71981";"   34354";"     309";"   46908";"   34314";"  504413";"  338428";"  100146";"   65839";"  390617";"   85586";"  174493";"  130538";"       0";"       0";"       0"
"Amsterdam Airport Schiphol";"2008 March";"   35444";"     339";"   17099";"   16229";"     870";"   17108";"   16246";"     862";" 1891982";" 1811983";"   79999";" 1849516";" 1769984";"   79532";" 3741498";" 2458467";" 2104504";"  353963";" 1283031";"  210536";"   84417";"   37694";"     438";"   49399";"   38588";"  618652";"  444650";"  102142";"   71860";"  453843";"  110469";"  182250";"  161124";"       0";"       0";"       0"
"Amsterdam Airport Schiphol";"2008 April";"   37413";"     456";"   18105";"   16938";"    1167";"   18113";"   16976";"    1137";" 1878915";" 1792851";"   86064";" 2039804";" 1899414";"  140390";" 3918719";" 2647271";" 2234222";"  413049";" 1271448";"  189481";"   85825";"   36965";"       0";"   35190";"   31501";"  641464";"  477488";"   94862";"   69114";"  440503";"  109717";"  165132";"  165654";"       0";"       0";"       0"
"Amsterdam Airport Schiphol";"2008 May";"   40482";"     463";"   19583";"   17742";"    1841";"   19589";"   17741";"    1848";" 2260285";" 2027121";"  233164";" 2143164";" 1916214";"  226950";" 4403449";" 3063829";" 2538621";"  525208";" 1339620";"  195332";"   91831";"   36218";"       0";"   39402";"   27881";"  719165";"  554222";"   94616";"   70327";"  425123";"  106876";"  158805";"  159442";"       0";"       0";"       0"
"Amsterdam Airport Schiphol";"2008 June";"   39731";"     446";"   19103";"   17327";"    1776";"   19099";"   17336";"    1763";" 2163721";" 1956658";"  207063";" 2236686";" 2005620";"  231066";" 4400407";" 3029210";" 2515360";"  513850";" 1371197";"  206050";"   84039";"   39548";"       0";"   55230";"   27233";"  734132";"  571774";"   91104";"   71254";"  431015";"  110894";"  160510";"  159611";"       0";"       0";"       0"
"Amsterdam Airport Schiphol";"2008 July";"   40917";"     408";"   19869";"   17547";"    2322";"   19890";"   17576";"    2314";" 2321201";" 2016747";"  304454";" 2526272";" 2160520";"  365752";" 4847473";" 3328794";" 2727241";"  601553";" 1518679";"  258665";"  124456";"   44995";"       0";"   59079";"   30135";"  785198";"  600306";"  102269";"   82623";"  474816";"  128560";"  177135";"  169121";"       0";"       0";"       0"
"Amsterdam Airport Schiphol";"2008 August";"   40059";"     405";"   19554";"   17233";"    2321";"   19560";"   17259";"    2301";" 2490123";" 2138939";"  351184";" 2226013";" 1943725";"  282288";" 4716136";" 3197701";" 2635950";"  561751";" 1518435";"  252021";"  118228";"   46322";"       0";"   58001";"   29470";"  789682";"  604419";"  103477";"   81786";"  476732";"  133740";"  172954";"  170038";"       0";"       0";"       0"
"Amsterdam Airport Schiphol";"2008 September";"   38727";"     401";"   18742";"   17089";"    1653";"   18729";"   17096";"    1633";" 2151099";" 1941124";"  209975";" 2146341";" 1938411";"  207930";" 4297440";" 2957380";" 2468714";"  488666";" 1340060";"  208163";"   83028";"   42324";"       0";"   53210";"   29601";"  714221";"  554108";"   85119";"   74994";"  417676";"   97559";"  156745";"  163372";"       0";"       0";"       0"
"Amsterdam Airport Schiphol";"2008 October";"   39201";"     429";"   19045";"   17512";"    1533";"   19045";"   17523";"    1522";" 2159699";" 1955541";"  204158";" 2112554";" 1943765";"  168789";" 4272253";" 2886507";" 2387028";"  499479";" 1385746";"  235155";"  104933";"   38653";"     130";"   55866";"   35573";"  701390";"  530774";"   95362";"   75254";"  449201";"  111931";"  165621";"  171649";"       0";"       0";"       0"
"Amsterdam Airport Schiphol";"2008 November";"   32913";"     360";"   16014";"   15320";"     694";"   16015";"   15340";"     675";" 1648293";" 1587907";"   60386";" 1623541";" 1570050";"   53491";" 3271834";" 2109255";" 1804169";"  305086";" 1162579";"  206309";"   76501";"   40310";"       0";"   53226";"   36272";"  554525";"  393225";"   94725";"   66575";"  401745";"   96648";"  160428";"  144669";"       0";"       0";"       0"
"Amsterdam Airport Schiphol";"2008 December";"   31104";"     358";"   15191";"   14503";"     688";"   15147";"   14478";"     669";" 1553743";" 1502226";"   51517";" 1614645";" 1555286";"   59359";" 3168388";" 1973801";" 1681497";"  292304";" 1194587";"  204715";"   68101";"   42901";"      60";"   56046";"   37607";"  588793";"  421975";"   99254";"   67564";"  401079";"  102200";"  166126";"  132753";"       0";"       0";"       0"
"Amsterdam Airport Schiphol";"2009 January";"   30635";"     372";"   14886";"   14276";"     610";"   14957";"   14358";"     599";" 1484402";" 1434913";"   49489";" 1427346";" 1384080";"   43266";" 2911748";" 1770284";" 1499898";"  270386";" 1141464";"  197612";"   59519";"   42178";"       0";"   59377";"   36538";"  545365";"  369811";"  107673";"   67881";"  398487";"   89904";"  175958";"  132625";"       0";"       0";"       0"
"Amsterdam Airport Schiphol";"2009 February";"   28408";"     352";"   13775";"   13173";"     602";"   13780";"   13194";"     586";" 1349352";" 1297887";"   51465";" 1371647";" 1315985";"   55662";" 2720999";" 1761430";" 1497953";"  263477";"  959569";"  182847";"   64076";"   32990";"     109";"   54202";"   31470";"  432998";"  283725";"   94413";"   54860";"  343724";"   76367";"  145826";"  121531";"       0";"       0";"       0"
"Amsterdam Airport Schiphol";"2009 March";"   32379";"     384";"   15757";"   15098";"     659";"   15746";"   15098";"     648";" 1623572";" 1566088";"   57484";" 1576346";" 1521782";"   54564";" 3199918";" 2085984";" 1777124";"  308860";" 1113934";"  195240";"   73969";"   37159";"       0";"   50444";"   33668";"  532118";"  372212";"  100731";"   59175";"  386576";"   95076";"  151166";"  140334";"       0";"       0";"       0"
"Amsterdam Airport Schiphol";"2009 April";"   34185";"     428";"   16629";"   15703";"     926";"   16627";"   15724";"     903";" 1788469";" 1714746";"   73723";" 1884154";" 1775489";"  108665";" 3672623";" 2463559";" 2062549";"  401010";" 1209064";"  194028";"   79198";"   37730";"       0";"   47014";"   30086";"  600938";"  445827";"   97005";"   58106";"  414098";"  112737";"  144963";"  156398";"       0";"       0";"       0"
"Amsterdam Airport Schiphol";"2009 May";"   36295";"     438";"   17631";"   16190";"    1441";"   17633";"   16196";"    1437";" 1982098";" 1796304";"  185794";" 1909915";" 1732934";"  176981";" 3892013";" 2705907";" 2234094";"  471813";" 1186106";"  189496";"   80984";"   35930";"       0";"   47032";"   25550";"  624908";"  483044";"   84092";"   57772";"  371702";"   96909";"  132997";"  141796";"       0";"       0";"       0"
"Amsterdam Airport Schiphol";"2009 June";"   35406";"     471";"   17152";"   15842";"    1310";"   17156";"   15857";"    1299";" 1934577";" 1773368";"  161209";" 1916268";" 1753742";"  162526";" 3850845";" 2639673";" 2182500";"  457173";" 1211172";"  193502";"   71405";"   34874";"       0";"   60164";"   27059";"  648069";"  499957";"   85654";"   62458";"  369601";"  100589";"  133087";"  135925";"       0";"       0";"       0"
"Amsterdam Airport Schiphol";"2009 July";"   37616";"     436";"   18323";"   16202";"    2121";"   18343";"   16216";"    2127";" 2130115";" 1870056";"  260059";" 2402352";" 2070239";"  332113";" 4532467";" 3109369";" 2541454";"  567915";" 1423098";"  262432";"  117408";"   41278";"       0";"   71735";"   32011";"  709298";"  530073";"  105397";"   73828";"  451368";"  126624";"  155626";"  169118";"       0";"       0";"       0"
"Amsterdam Airport Schiphol";"2009 August";"   37121";"     523";"   18193";"   16042";"    2151";"   18179";"   16029";"    2150";" 2381512";" 2048887";"  332625";" 2103227";" 1845677";"  257550";" 4484739";" 3037777";" 2503581";"  534196";" 1446962";"  258303";"  110861";"   45281";"       0";"   71207";"   30954";"  718515";"  535393";"  107827";"   75295";"  470144";"  132266";"  158437";"  179441";"       0";"       0";"       0"
"Amsterdam Airport Schiphol";"2009 September";"   35147";"     393";"   17091";"   15662";"    1429";"   17093";"   15662";"    1431";" 2017934";" 1827931";"  190003";" 1997038";" 1820799";"  176239";" 4014972";" 2752356";" 2294242";"  458114";" 1262616";"  212145";"   79900";"   42049";"       0";"   60368";"   29828";"  639598";"  481862";"   87626";"   70110";"  410873";"   91728";"  145899";"  173246";"       0";"       0";"       0"
"Amsterdam Airport Schiphol";"2009 October";"   35291";"     322";"   17151";"   15797";"    1354";"   17164";"   15799";"    1365";" 2012119";" 1836211";"  175908";" 1971639";" 1827137";"  144502";" 3983758";" 2677612";" 2197961";"  479651";" 1306146";"  239885";"   99796";"   39892";"       0";"   62603";"   37594";"  628841";"  463492";"   94786";"   70563";"  437420";"  103767";"  163425";"  170228";"       0";"       0";"       0"
"Amsterdam Airport Schiphol";"2009 November";"   30709";"     385";"   14922";"   14302";"     620";"   14898";"   14301";"     597";" 1593790";" 1533828";"   59962";" 1564669";" 1516155";"   48514";" 3158459";" 2049798";" 1745357";"  304441";" 1108661";"  202332";"   76440";"   36003";"       0";"   53669";"   36220";"  507897";"  354377";"   92415";"   61105";"  398432";"   91927";"  161560";"  144945";"       0";"       0";"       0"
"Amsterdam Airport Schiphol";"2009 December";"   28934";"     345";"   14114";"   13483";"     631";"   14065";"   13436";"     629";" 1528222";" 1477349";"   50873";" 1572347";" 1518902";"   53445";" 3100569";" 1936722";" 1639890";"  296832";" 1163847";"  211488";"   74171";"   42444";"       0";"   59083";"   35790";"  543259";"  383384";"   95586";"   64289";"  409100";"  100746";"  168537";"  139817";"       0";"       0";"       0"
"Amsterdam Airport Schiphol";"2010 January";"   29186";"     308";"   14207";"   13618";"     589";"   14263";"   13701";"     562";" 1489035";" 1434015";"   55020";" 1446369";" 1399251";"   47118";" 2935404";" 1784929";" 1498289";"  286640";" 1150475";"  212738";"   70782";"   40867";"       0";"   66080";"   35009";"  524222";"  348767";"  106080";"   69375";"  413515";"   90772";"  178134";"  144609";"       0";"       0";"       0"
"Amsterdam Airport Schiphol";"2010 February";"   27839";"     330";"   13550";"   12903";"     647";"   13552";"   12926";"     626";" 1416049";" 1358482";"   57567";" 1439670";" 1377505";"   62165";" 2855719";" 1847977";" 1564956";"  283021";" 1007742";"  197105";"   75576";"   32329";"       0";"   58923";"   30277";"  438838";"  286262";"   94933";"   57643";"  371799";"   81450";"  154687";"  135662";"       0";"       0";"       0"
"Amsterdam Airport Schiphol";"2010 March";"   32397";"     489";"   15688";"   14943";"     745";"   15685";"   14970";"     715";" 1762140";" 1690535";"   71605";" 1703471";" 1635954";"   67517";" 3465611";" 2249379";" 1897497";"  351882";" 1216232";"  221296";"   91224";"   38467";"       0";"   57596";"   34009";"  548050";"  386175";"  100776";"   61099";"  446886";"  107724";"  172209";"  166953";"       0";"       0";"       0"
"Amsterdam Airport Schiphol";"2010 April";"   27514";"     466";"   13333";"   12456";"     877";"   13354";"   12475";"     879";" 1472647";" 1399766";"   72881";" 1534338";" 1435111";"   99227";" 3006985";" 1950351";" 1625490";"  324861";" 1056634";"  178649";"   77352";"   34491";"     197";"   41950";"   24659";"  511218";"  370691";"   86588";"   53939";"  366767";"   94737";"  135991";"  136039";"       0";"       0";"       0"
"Amsterdam Airport Schiphol";"2010 May";"   35594";"     404";"   17314";"   15495";"    1819";"   17309";"   15506";"    1803";" 2068682";" 1842889";"  225793";" 2026428";" 1787845";"  238583";" 4095110";" 2805648";" 2280039";"  525609";" 1289462";"  209826";"   94549";"   38374";"       0";"   51295";"   25608";"  650994";"  488555";"   99332";"   63107";"  428642";"  115489";"  141085";"  172068";"       0";"       0";"       0"
"Amsterdam Airport Schiphol";"2010 June";"   35506";"     559";"   17178";"   15621";"    1557";"   17168";"   15608";"    1560";" 2058823";" 1871945";"  186878";" 2045970";" 1861162";"  184808";" 4104793";" 2748330";" 2268510";"  479820";" 1356463";"  221705";"   85137";"   35692";"       0";"   67598";"   33278";"  684091";"  528117";"   91472";"   64502";"  450667";"  120685";"  150375";"  179607";"       0";"       0";"       0"
"Amsterdam Airport Schiphol";"2010 July";"   38009";"     420";"   18505";"   16057";"    2448";"   18531";"   16063";"    2468";" 2235501";" 1937310";"  298191";" 2495287";" 2121243";"  374044";" 4730788";" 3179518";" 2583777";"  595741";" 1551270";"  295677";"  136571";"   40599";"       0";"   79017";"   39490";"  744723";"  561555";"  109358";"   73810";"  510870";"  150924";"  172943";"  187003";"       0";"       0";"       0"
"Amsterdam Airport Schiphol";"2010 August";"   37601";"     496";"   18370";"   15990";"    2380";"   18358";"   15956";"    2402";" 2468269";" 2095443";"  372826";" 2174457";" 1879864";"  294593";" 4642726";" 3120870";" 2551625";"  569245";" 1521856";"  273230";"  122696";"   41807";"       0";"   78100";"   30627";"  738406";"  558618";"  105300";"   74488";"  510220";"  159234";"  166573";"  184413";"       0";"       0";"       0"
"Amsterdam Airport Schiphol";"2010 September";"   35697";"     398";"   17292";"   15646";"    1646";"   17291";"   15660";"    1631";" 2129844";" 1901621";"  228223";" 2117075";" 1902032";"  215043";" 4246919";" 2879591";" 2379834";"  499757";" 1367328";"  237019";"   98564";"   38158";"     770";"   69674";"   29853";"  669142";"  504155";"   94830";"   70157";"  461167";"  125472";"  150922";"  184773";"       0";"       0";"       0"
"Amsterdam Airport Schiphol";"2010 October";"   36530";"     449";"   17727";"   16044";"    1683";"   17726";"   16064";"    1662";" 2179048";" 1952006";"  227042";" 2128984";" 1940841";"  188143";" 4308032";" 2905747";" 2352510";"  553237";" 1402285";"  261403";"  122013";"   37271";"     535";"   70061";"   31523";"  666264";"  489656";"  104415";"   72193";"  474618";"  132230";"  165119";"  177269";"       0";"       0";"       0"
"Amsterdam Airport Schiphol";"2010 November";"   32321";"     395";"   15715";"   14845";"     870";"   15702";"   14869";"     833";" 1777568";" 1688516";"   89052";" 1730586";" 1657440";"   73146";" 3508154";" 2293615";" 1942322";"  351293";" 1214539";"  227207";"   96294";"   36266";"    2659";"   59243";"   32745";"  551279";"  380958";"  104049";"   66272";"  436053";"  119464";"  163734";"  152855";"       0";"       0";"       0"
"Amsterdam Airport Schiphol";"2010 December";"   29220";"     247";"   14262";"   13402";"     860";"   14236";"   13359";"     877";" 1602991";" 1531971";"   71020";" 1633650";" 1558984";"   74666";" 3236641";" 2006306";" 1691178";"  315128";" 1230335";"  228549";"   93221";"   39269";"    2376";"   58726";"   34957";"  567625";"  393385";"  108152";"   66088";"  434161";"  121532";"  172299";"  140330";"       0";"       0";"       0"
"Amsterdam Airport Schiphol";"2011 January";"   31233";"     374";"   15163";"   14419";"     744";"   15200";"   14475";"     725";" 1658258";" 1582936";"   75322";" 1599017";" 1533019";"   65998";" 3257275";" 2016202";" 1697165";"  319037";" 1241073";"  234287";"   87336";"   40100";"    2130";"   69539";"   35182";"  543475";"  360011";"  112068";"   71396";"  463311";"  117751";"  184480";"  161080";"       0";"       0";"       0"
"Amsterdam Airport Schiphol";"2011 February";"   28891";"     288";"   14027";"   13364";"     663";"   14021";"   13393";"     628";" 1511230";" 1451020";"   60210";" 1534401";" 1469076";"   65325";" 3045631";" 2013665";" 1706782";"  306883";" 1031966";"  169848";"   41405";"   32780";"    1950";"   63417";"   30296";"  449995";"  288556";"  101740";"   59699";"  412123";"  107744";"  161993";"  142386";"       0";"       0";"       0"
"Amsterdam Airport Schiphol";"2011 March";"   33910";"     421";"   16439";"   15626";"     813";"   16439";"   15658";"     781";" 1862668";" 1778611";"   84057";" 1795024";" 1715421";"   79603";" 3657692";" 2454087";" 2077934";"  376153";" 1203605";"  186151";"   55807";"   37817";"    2394";"   57149";"   32984";"  559728";"  386726";"  106957";"   66045";"  457726";"  124860";"  170818";"  162048";"       0";"       0";"       0"
"Amsterdam Airport Schiphol";"2011 April";"   36349";"     499";"   17639";"   16506";"    1133";"   17653";"   16536";"    1117";" 2035770";" 1937967";"   97803";" 2089977";" 1951157";"  138820";" 4125747";" 2828147";" 2355821";"  472326";" 1297600";"  203195";"   76526";"   41292";"    2000";"   49437";"   33940";"  633837";"  456210";"  108487";"   69140";"  460568";"  138211";"  160157";"  162200";"       0";"       0";"       0"
"Amsterdam Airport Schiphol";"2011 May";"   39153";"     497";"   19010";"   17450";"    1560";"   19003";"   17465";"    1538";" 2264713";" 2072248";"  192465";" 2207794";" 2012966";"  194828";" 4472507";" 3164177";" 2593747";"  570430";" 1308330";"  183964";"   68046";"   37847";"    2222";"   50124";"   25725";"  673676";"  502854";"  101065";"   69757";"  450690";"  132202";"  148688";"  169800";"       0";"       0";"       0"
"Amsterdam Airport Schiphol";"2011 June";"   38061";"     375";"   18457";"   16996";"    1461";"   18463";"   17010";"    1453";" 2266956";" 2082858";"  184098";" 2246499";" 2060454";"  186045";" 4513455";" 3143255";" 2597017";"  546238";" 1370200";"  198847";"   73536";"   36269";"    3405";"   59955";"   25682";"  711999";"  546184";"   98194";"   67621";"  459354";"  140583";"  148208";"  170563";"       0";"       0";"       0"
"Amsterdam Airport Schiphol";"2011 July";"   40488";"     426";"   19772";"   17556";"    2216";"   19783";"   17578";"    2205";" 2449989";" 2170887";"  279102";" 2700907";" 2355790";"  345117";" 5150896";" 3570199";" 2889156";"  681043";" 1580697";"  267472";"  117205";"   42413";"    3791";"   73160";"   30903";"  779420";"  586694";"  116042";"   76684";"  533805";"  170029";"  171228";"  192548";"       0";"       0";"       0"
"Amsterdam Airport Schiphol";"2011 August";"   40566";"     453";"   19818";"   17579";"    2239";"   19813";"   17570";"    2243";" 2648185";" 2300463";"  347722";" 2409630";" 2108384";"  301246";" 5057815";" 3491964";" 2837020";"  654944";" 1565851";"  250955";"   98738";"   44356";"    3751";"   73850";"   30260";"  779716";"  580401";"  119778";"   79537";"  535180";"  170923";"  169815";"  194442";"       0";"       0";"       0"
"Amsterdam Airport Schiphol";"2011 September";"   38768";"     491";"   18792";"   17148";"    1644";"   18805";"   17161";"    1644";" 2361577";" 2128288";"  233289";" 2320165";" 2099100";"  221065";" 4681742";" 3257385";" 2681933";"  575452";" 1424357";"  226412";"   85445";"   41842";"    2759";"   66319";"   30047";"  707812";"  533424";"   97210";"   77178";"  490133";"  144481";"  156508";"  189144";"       0";"       0";"       0"
"Amsterdam Airport Schiphol";"2011 October";"   39074";"     445";"   19040";"   17440";"    1600";"   19026";"   17430";"    1596";" 2326155";" 2110756";"  215399";" 2277527";" 2096199";"  181328";" 4603682";" 3183023";" 2570795";"  612228";" 1420659";"  235298";"   91068";"   44325";"    2615";"   65269";"   32021";"  687339";"  507032";"  105567";"   74740";"  498022";"  142275";"  165739";"  190008";"       0";"       0";"       0"
"Amsterdam Airport Schiphol";"2011 November";"   33204";"     371";"   16163";"   15432";"     731";"   16161";"   15440";"     721";" 1806670";" 1732768";"   73902";" 1773511";" 1710496";"   63015";" 3580181";" 2399397";" 2029157";"  370240";" 1180784";"  214130";"   84946";"   39215";"    2314";"   54056";"   33599";"  539006";"  364080";"   96729";"   78197";"  427648";"  118906";"  153569";"  155173";"       0";"       0";"       0"
"Amsterdam Airport Schiphol";"2011 December";"   32424";"     322";"   15796";"   15172";"     624";"   15762";"   15168";"     594";" 1725807";" 1676472";"   49335";" 1808195";" 1751751";"   56444";" 3534002";" 2303809";" 1960664";"  343145";" 1230193";"  216256";"   76534";"   41523";"    2657";"   58630";"   36912";"  568994";"  378635";"  103320";"   87039";"  444943";"  124553";"  171839";"  148551";"       0";"       0";"       0"
"Amsterdam Airport Schiphol";"2012 January";"   31911";"     338";"   15555";"   14917";"     638";"   15579";"   14980";"     599";" 1747950";" 1685509";"   62441";" 1674812";" 1618355";"   56457";" 3422762";" 2195330";" 1850565";"  344765";" 1227432";"  217000";"   73473";"   39581";"    2845";"   65300";"   35801";"  552310";"  352218";"  109716";"   90376";"  458122";"  120275";"  182011";"  155836";"       0";"       0";"       0"
"Amsterdam Airport Schiphol";"2012 February";"   30805";"     283";"   15035";"   14366";"     669";"   15034";"   14418";"     616";" 1619746";" 1560276";"   59470";" 1675463";" 1610766";"   64697";" 3295209";" 2177863";" 1843735";"  334128";" 1117346";"  207024";"   74514";"   37424";"    2764";"   60551";"   31771";"  493172";"  307976";"  102667";"   82529";"  417150";"  112158";"  163542";"  141450";"       0";"       0";"       0"
"Amsterdam Airport Schiphol";"2012 March";"   34921";"     321";"   16923";"   16175";"     748";"   16948";"   16218";"     730";" 1973751";" 1903590";"   70161";" 1894342";" 1827395";"   66947";" 3868093";" 2589361";" 2183122";"  406239";" 1278732";"  220458";"   81567";"   37769";"    3215";"   61452";"   36455";"  582609";"  395584";"  104448";"   82577";"  475665";"  134027";"  170677";"  170961";"       0";"       0";"       0"
"Amsterdam Airport Schiphol";"2012 April";"   36291";"     342";"   17682";"   16673";"    1009";"   17666";"   16719";"     947";" 2061795";" 1979679";"   82116";" 2127450";" 2009542";"  117908";" 4189245";" 2875204";" 2372473";"  502731";" 1314041";"  215358";"   86536";"   40650";"    3729";"   50516";"   33927";"  632793";"  448685";"  100639";"   83469";"  465890";"  132969";"  155130";"  177791";"       0";"       0";"       0"
"Amsterdam Airport Schiphol";"2012 May";"   39221";"     312";"   19060";"   17530";"    1530";"   19058";"   17528";"    1530";" 2285340";" 2089351";"  195989";" 2258992";" 2054771";"  204221";" 4544332";" 3199268";" 2584756";"  614512";" 1345064";"  202397";"   82997";"   35327";"    3866";"   51783";"   28424";"  689656";"  507108";"   97480";"   85068";"  453011";"  121092";"  146795";"  185124";"       0";"       0";"       0"
"Amsterdam Airport Schiphol";"2012 June";"   38460";"     383";"   18719";"   17134";"    1585";"   18730";"   17166";"    1564";" 2304960";" 2101919";"  203041";" 2307885";" 2089196";"  218689";" 4612845";" 3193777";" 2576910";"  616867";" 1419068";"  213782";"   84952";"   30777";"    5057";"   61755";"   31241";"  737922";"  560976";"   94950";"   81996";"  467364";"  121150";"  152134";"  194080";"       0";"       0";"       0"
"Amsterdam Airport Schiphol";"2012 July";"   40898";"     323";"   20005";"   17773";"    2232";"   20007";"   17839";"    2168";" 2465269";" 2174027";"  291242";" 2756326";" 2394529";"  361797";" 5221595";" 3616378";" 2853546";"  762832";" 1605217";"  287292";"  133859";"   37105";"    5647";"   74892";"   35789";"  800062";"  595999";"  108800";"   95263";"  517863";"  138369";"  166394";"  213100";"       0";"       0";"       0"
"Amsterdam Airport Schiphol";"2012 August";"   40602";"     311";"   19921";"   17715";"    2206";"   19928";"   17714";"    2214";" 2687277";" 2341651";"  345626";" 2450228";" 2144112";"  306116";" 5137505";" 3513351";" 2796249";"  717102";" 1624154";"  286117";"  129514";"   38228";"    5715";"   77006";"   35654";"  804095";"  602428";"  108512";"   93155";"  533942";"  150503";"  166909";"  216530";"       0";"       0";"       0"
"Amsterdam Airport Schiphol";"2012 September";"   38523";"     281";"   18757";"   17096";"    1661";"   18731";"   17092";"    1639";" 2397080";" 2154734";"  242346";" 2363359";" 2131468";"  231891";" 4760439";" 3301087";" 2675309";"  625778";" 1459352";"  241363";"   97245";"   37054";"    5581";"   66401";"   35082";"  730943";"  543005";"   95888";"   92050";"  487046";"  124550";"  153352";"  209144";"       0";"       0";"       0"
"Amsterdam Airport Schiphol";"2012 October";"   38645";"     303";"   18895";"   17362";"    1533";"   18887";"   17387";"    1500";" 2347644";" 2138973";"  208671";" 2296053";" 2126709";"  169344";" 4643697";" 3210326";" 2580540";"  629786";" 1433371";"  251167";"  104208";"   38407";"    4991";"   66171";"   37390";"  687633";"  495683";"  100804";"   91146";"  494571";"  138796";"  157513";"  198262";"       0";"       0";"       0"
"Amsterdam Airport Schiphol";"2012 November";"   32956";"     278";"   16029";"   15259";"     770";"   16035";"   15306";"     729";" 1860056";" 1781156";"   78900";" 1832211";" 1764126";"   68085";" 3692267";" 2475265";" 2082343";"  392922";" 1217002";"  226298";"   88386";"   41335";"    4767";"   54535";"   37275";"  548682";"  362548";"   97882";"   88252";"  442022";"  117274";"  165100";"  159648";"       0";"       0";"       0"
"Amsterdam Airport Schiphol";"2012 December";"   30891";"     291";"   15130";"   14406";"     724";"   15091";"   14438";"     653";" 1753514";" 1693697";"   59817";" 1834089";" 1763084";"   71005";" 3587603";" 2300056";" 1931403";"  368653";" 1287547";"  234551";"   82703";"   45963";"    5434";"   58559";"   41892";"  581768";"  382972";"  103431";"   95365";"  471228";"  130643";"  184843";"  155742";"       0";"       0";"       0"
"Amsterdam Airport Schiphol";"2013 January";"   30705";"     299";"   14953";"   14313";"     640";"   14996";"   14386";"     610";" 1718718";" 1651749";"   66969";" 1667513";" 1607175";"   60338";" 3386231";" 2116044";" 1758731";"  357313";" 1270187";"  235073";"   77744";"   46922";"    5762";"   63850";"   40795";"  565379";"  354728";"  110044";"  100607";"  469735";"  121477";"  189528";"  158730";"       0";"       0";"       0"
"Amsterdam Airport Schiphol";"2013 February";"   29469";"     268";"   14356";"   13638";"     718";"   14350";"   13688";"     662";" 1619700";" 1550147";"   69553";" 1646109";" 1572503";"   73606";" 3265809";" 2150859";" 1795354";"  355505";" 1114950";"  216462";"   79738";"   40104";"    4443";"   57199";"   34978";"  480480";"  296501";"   98334";"   85645";"  418008";"  111327";"  159885";"  146796";"       0";"       0";"       0"
"Amsterdam Airport Schiphol";"2013 March";"   33873";"     366";"   16489";"   15661";"     828";"   16500";"   15721";"     779";" 2004006";" 1918320";"   85686";" 1964003";" 1877225";"   86778";" 3968009";" 2632427";" 2197317";"  435110";" 1335582";"  233748";"   90685";"   43447";"    5089";"   52702";"   41825";"  608364";"  401860";"  110320";"   96184";"  493470";"  137605";"  177813";"  178052";"       0";"       0";"       0"
"Amsterdam Airport Schiphol";"2013 April";"   36889";"     334";"   17998";"   16953";"    1045";"   17992";"   17013";"     979";" 2124194";" 2033116";"   91078";" 2208525";" 2079118";"  129407";" 4332719";" 2967311";" 2436293";"  531018";" 1365408";"  218709";"   99591";"   38812";"    4531";"   42926";"   32849";"  664912";"  468365";"  103231";"   93316";"  481787";"  131468";"  154166";"  196153";"       0";"       0";"       0"
"Amsterdam Airport Schiphol";"2013 May";"   40101";"     294";"   19494";"   17927";"    1567";"   19508";"   17917";"    1591";" 2457244";" 2238681";"  218563";" 2407091";" 2189021";"  218070";" 4864335";" 3431310";" 2757432";"  673878";" 1433025";"  215562";"   98226";"   31529";"    5265";"   49724";"   30818";"  740154";"  545695";"  100746";"   93713";"  477309";"  129313";"  150420";"  197576";"       0";"       0";"       0"
"Amsterdam Airport Schiphol";"2013 June";"   38857";"     363";"   18912";"   17419";"    1493";"   18904";"   17439";"    1465";" 2420261";" 2223320";"  196941";" 2435316";" 2224674";"  210642";" 4855577";" 3336400";" 2711236";"  625164";" 1519177";"  227973";"   94232";"   32308";"    5705";"   63312";"   32416";"  790054";"  595426";"   98474";"   96154";"  501150";"  139081";"  153598";"  208471";"       0";"       0";"       0"
"Amsterdam Airport Schiphol";"2013 July";"   41018";"     375";"   20056";"   17866";"    2190";"   20069";"   17906";"    2163";" 2519776";" 2228037";"  291739";" 2802792";" 2444214";"  358578";" 5322568";" 3674591";" 2926046";"  748545";" 1647977";"  267378";"  118631";"   36020";"    6698";"   70815";"   35214";"  835820";"  619607";"  106387";"  109826";"  544779";"  159067";"  164126";"  221586";"       0";"       0";"       0"
"Amsterdam Airport Schiphol";"2013 August";"   40786";"     320";"   20000";"   17836";"    2164";"   20004";"   17794";"    2210";" 2785074";" 2432425";"  352649";" 2548400";" 2243005";"  305395";" 5333474";" 3631055";" 2888915";"  742140";" 1702419";"  283518";"  131299";"   38424";"    7685";"   70082";"   36028";"  854470";"  641256";"  106840";"  106374";"  564431";"  171505";"  168922";"  224004";"       0";"       0";"       0"
"Amsterdam Airport Schiphol";"2013 September";"   39355";"     349";"   19148";"   17578";"    1570";"   19126";"   17560";"    1566";" 2462704";" 2228425";"  234279";" 2434470";" 2212445";"  222025";" 4897174";" 3409623";" 2773296";"  636327";" 1487551";"  211793";"   74244";"   36726";"    6629";"   60504";"   33690";"  764189";"  560859";"   97788";"  105542";"  511569";"  144898";"  153126";"  213545";"       0";"       0";"       0"
"Amsterdam Airport Schiphol";"2013 October";"   39234";"     315";"   19153";"   17774";"    1379";"   19155";"   17764";"    1391";" 2389293";" 2194284";"  195009";" 2356403";" 2196685";"  159718";" 4745696";" 3304504";" 2651597";"  652907";" 1441192";"  210432";"   70871";"   41108";"    5896";"   58351";"   34206";"  711444";"  510374";"  101966";"   99104";"  519316";"  151822";"  159698";"  207796";"       0";"       0";"       0"
"Amsterdam Airport Schiphol";"2013 November";"   33461";"     288";"   16315";"   15660";"     655";"   16307";"   15665";"     642";" 1900072";" 1826597";"   73475";" 1872553";" 1810008";"   62545";" 3772625";" 2552602";" 2137734";"  414868";" 1220023";"  196108";"   52824";"   45574";"    5933";"   53380";"   38397";"  562778";"  366656";"  104470";"   91652";"  461137";"  138856";"  159165";"  163116";"       0";"       0";"       0"
"Amsterdam Airport Schiphol";"2013 December";"   32455";"     277";"   15919";"   15327";"     592";"   15861";"   15296";"     565";" 1856353";" 1799394";"   56959";" 1927129";" 1866806";"   60323";" 3783482";" 2464710";" 2066267";"  398443";" 1318772";"  219303";"   61825";"   50171";"    6437";"   57151";"   43719";"  612527";"  401980";"  109405";"  101142";"  486942";"  156569";"  174901";"  155472";"       0";"       0";"       0"
"Amsterdam Airport Schiphol";"2014 January";"   32093";"     332";"   15670";"   15105";"     565";"   15722";"   15156";"     566";" 1827701";" 1768547";"   59154";" 1788851";" 1734524";"   54327";" 3616552";" 2301528";" 1924373";"  377155";" 1315024";"  219311";"   57404";"   52249";"    6614";"   60535";"   42509";"  587706";"  363828";"  119512";"  104366";"  508007";"  156163";"  182518";"  169326";"       0";"       0";"       0"
"Amsterdam Airport Schiphol";"2014 February";"   30200";"     279";"   14721";"   14093";"     628";"   14729";"   14096";"     633";" 1696356";" 1635267";"   61089";" 1739236";" 1673515";"   65721";" 3435592";" 2289187";" 1917733";"  371454";" 1146405";"  202788";"   59355";"   45028";"    5461";"   55842";"   37102";"  492916";"  302449";"  102405";"   88062";"  450701";"  143655";"  155965";"  151081";"       0";"       0";"       0"
"Amsterdam Airport Schiphol";"2014 March";"   35021";"     332";"   17024";"   16331";"     693";"   17009";"   16330";"     679";" 2066733";" 1986913";"   79820";" 2009739";" 1934641";"   75098";" 4076472";" 2744289";" 2307481";"  436808";" 1332183";"  221023";"   71702";"   48868";"    5782";"   53691";"   40980";"  602415";"  392758";"  110085";"   99572";"  508745";"  164360";"  163313";"  181072";"       0";"       0";"       0"
"Amsterdam Airport Schiphol";"2014 April";"   37505";"     347";"   18312";"   17231";"    1081";"   18318";"   17272";"    1046";" 2226261";" 2123666";"  102595";" 2334381";" 2188600";"  145781";" 4560642";" 3168885";" 2616545";"  552340";" 1391757";"  215390";"   79454";"   43600";"    6256";"   49712";"   36368";"  662304";"  455864";"  104163";"  102277";"  514063";"  167717";"  154168";"  192178";"       0";"       0";"       0"
"Amsterdam Airport Schiphol";"2014 May";"   40531";"     311";"   19738";"   18218";"    1520";"   19755";"   18206";"    1549";" 2516085";" 2305878";"  210207";" 2471866";" 2253705";"  218161";" 4987951";" 3537385";" 2878680";"  658705";" 1450566";"  203071";"   73856";"   34555";"    7234";"   51588";"   35838";"  749101";"  541965";"  102596";"  104540";"  498394";"  146253";"  154397";"  197744";"       0";"       0";"       0"
"Amsterdam Airport Schiphol";"2014 June";"   39885";"     367";"   19401";"   17998";"    1403";"   19388";"   17988";"    1400";" 2539668";" 2336882";"  202786";" 2492969";" 2293328";"  199641";" 5032637";" 3539691";" 2908600";"  631091";" 1492946";"  204434";"   70081";"   30000";"    7263";"   61288";"   35802";"  787091";"  578705";"  101476";"  106910";"  501421";"  146203";"  153651";"  201567";"       0";"       0";"       0"
"Amsterdam Airport Schiphol";"2014 July";"   42105";"     321";"   20607";"   18538";"    2069";"   20620";"   18552";"    2068";" 2558772";" 2293959";"  264813";" 2896902";" 2554302";"  342600";" 5455674";" 3853130";" 3112911";"  740219";" 1602544";"  243902";"   96689";"   31925";"    8254";"   67984";"   39050";"  807744";"  585785";"  108410";"  113549";"  550898";"  165357";"  164677";"  220864";"       0";"       0";"       0"
"Amsterdam Airport Schiphol";"2014 August";"   42259";"     265";"   20715";"   18536";"    2179";"   20712";"   18510";"    2202";" 2934411";" 2569026";"  365385";" 2684025";" 2366386";"  317639";" 5618436";" 3902345";" 3136146";"  766199";" 1716091";"  280881";"  127473";"   33220";"    8369";"   72019";"   39800";"  844540";"  617576";"  112584";"  114380";"  590670";"  190317";"  169062";"  231291";"       0";"       0";"       0"
"Amsterdam Airport Schiphol";"2014 September";"   40680";"     273";"   19849";"   18309";"    1540";"   19836";"   18289";"    1547";" 2600130";" 2376826";"  223304";" 2585375";" 2374315";"  211060";" 5185505";" 3650216";" 3016558";"  633658";" 1535289";"  221658";"   82632";"   31939";"    7367";"   62566";"   37154";"  795183";"  578497";"  104849";"  111837";"  518448";"  152935";"  147984";"  217529";"       0";"       0";"       0"
"Amsterdam Airport Schiphol";"2014 October";"   40786";"     315";"   19878";"   18541";"    1337";"   19878";"   18508";"    1370";" 2535869";" 2338600";"  197269";" 2487699";" 2327259";"  160440";" 5023568";" 3546449";" 2893559";"  652890";" 1477119";"  220687";"   78875";"   36582";"    6163";"   62212";"   36855";"  739098";"  526499";"  106637";"  105962";"  517334";"  162128";"  155667";"  199539";"       0";"       0";"       0"
"Amsterdam Airport Schiphol";"2014 November";"   34397";"     265";"   16787";"   16172";"     615";"   16767";"   16162";"     605";" 1995290";" 1925959";"   69331";" 1977553";" 1920429";"   57124";" 3972843";" 2719549";" 2298319";"  421230";" 1253294";"  199762";"   62736";"   40708";"    6004";"   55356";"   34958";"  585079";"  384072";"  107998";"   93009";"  468453";"  142874";"  157122";"  168457";"       0";"       0";"       0"
"Amsterdam Airport Schiphol";"2014 December";"   33545";"     266";"   16452";"   15884";"     568";"   16407";"   15809";"     598";" 1956860";" 1906710";"   50150";" 2017802";" 1961227";"   56575";" 3974662";" 2650810";" 2238065";"  412745";" 1323852";"  217387";"   65416";"   44941";"    7213";"   62176";"   37641";"  624974";"  407761";"  115971";"  101242";"  481491";"  153537";"  168662";"  159292";"       0";"       0";"       0"
"Amsterdam Airport Schiphol";"2015 January";"   32746";"     283";"   15985";"   15414";"     571";"   16047";"   15463";"     584";" 1874235";" 1818301";"   55934";" 1845206";" 1793549";"   51657";" 3719441";" 2407878";" 1993858";"  414020";" 1311563";"  215254";"   62306";"   44842";"    7250";"   65620";"   35236";"  602564";"  373946";"  121244";"  107374";"  493745";"  149103";"  176454";"  168188";"       0";"       0";"       0"
"Amsterdam Airport Schiphol";"2015 February";"   31365";"     266";"   15298";"   14743";"     555";"   15309";"   14714";"     595";" 1782456";" 1725752";"   56704";" 1820188";" 1761364";"   58824";" 3602644";" 2458211";" 2046556";"  411655";" 1144433";"  193967";"   60059";"   35356";"    5821";"   60433";"   32298";"  506992";"  308215";"  106749";"   92028";"  443474";"  134920";"  151836";"  156718";"       0";"       0";"       0"
"Amsterdam Airport Schiphol";"2015 March";"   35498";"     255";"   17310";"   16702";"     608";"   17289";"   16683";"     606";" 2130477";" 2067363";"   63114";" 2063582";" 2007141";"   56441";" 4194059";" 2870299";" 2399081";"  471218";" 1323760";"  210779";"   65604";"   43624";"    6501";"   58290";"   36760";"  622212";"  402484";"  115104";"  104624";"  490769";"  148450";"  157953";"  184366";"       0";"       0";"       0"
"Amsterdam Airport Schiphol";"2015 April";"   38460";"     312";"   18797";"   17910";"     887";"   18805";"   17914";"     891";" 2333141";" 2257208";"   75933";" 2436853";" 2321960";"  114893";" 4769994";" 3365931";" 2798257";"  567674";" 1404063";"  209419";"   78088";"   43721";"    6054";"   51431";"   30125";"  697454";"  485299";"  105630";"  106525";"  497190";"  159174";"  140795";"  197221";"       0";"       0";"       0"
"Amsterdam Airport Schiphol";"2015 May";"   42132";"     281";"   20535";"   19050";"    1485";"   20537";"   18996";"    1541";" 2707937";" 2497151";"  210786";" 2672651";" 2450219";"  222432";" 5380588";" 3880734";" 3156850";"  723884";" 1499854";"  204011";"   76024";"   38026";"    7220";"   53473";"   29268";"  801872";"  579116";"  108063";"  114693";"  493971";"  155701";"  141172";"  197098";"       0";"       0";"       0"
"Amsterdam Airport Schiphol";"2015 June";"   41273";"     271";"   20035";"   18727";"    1308";"   20031";"   18692";"    1339";" 2660014";" 2475491";"  184523";" 2661286";" 2473528";"  187758";" 5321300";" 3781882";" 3109914";"  671968";" 1539418";"  200610";"   61512";"   35945";"    7127";"   66715";"   29311";"  831330";"  608987";"  106304";"  116039";"  507478";"  157569";"  138453";"  211456";"       0";"       0";"       0"
"Amsterdam Airport Schiphol";"2015 July";"   43503";"     282";"   21239";"   19202";"    2037";"   21255";"   19258";"    1997";" 2790465";" 2524382";"  266083";" 3123963";" 2786674";"  337289";" 5914428";" 4197398";" 3372613";"  824785";" 1717030";"  247180";"   94230";"   37527";"    8057";"   76096";"   31270";"  872530";"  626486";"  121865";"  124179";"  597320";"  193608";"  151270";"  252442";"       0";"       0";"       0"
"Amsterdam Airport Schiphol";"2015 August";"   43212";"     343";"   21176";"   19133";"    2043";"   21163";"   19083";"    2080";" 3107242";" 2768224";"  339018";" 2829996";" 2546476";"  283520";" 5937238";" 4150650";" 3326400";"  824250";" 1786588";"  266886";"  106511";"   40731";"    8793";"   77665";"   33186";"  893391";"  648241";"  121228";"  123922";"  626311";"  210165";"  158591";"  257555";"       0";"       0";"       0"
"Amsterdam Airport Schiphol";"2015 September";"   41616";"     251";"   20286";"   18947";"    1339";"   20272";"   18916";"    1356";" 2737082";" 2549688";"  187394";" 2729157";" 2551978";"  177179";" 5466239";" 3868276";" 3179873";"  688403";" 1597963";"  216632";"   74884";"   38698";"    7480";"   65143";"   30427";"  836065";"  603797";"  110657";"  121611";"  545266";"  170257";"  143685";"  231324";"       0";"       0";"       0"
"Amsterdam Airport Schiphol";"2015 October";"   41305";"     274";"   20108";"   18981";"    1127";"   20133";"   18963";"    1170";" 2678899";" 2519305";"  159594";" 2647473";" 2512034";"  135439";" 5326372";" 3768179";" 3091581";"  676598";" 1558193";"  217793";"   70668";"   45285";"    6586";"   62454";"   32800";"  796260";"  566462";"  113169";"  116629";"  544140";"  181221";"  148016";"  214903";"       0";"       0";"       0"
"Amsterdam Airport Schiphol";"2015 November";"   35487";"     258";"   17243";"   16762";"     481";"   17211";"   16747";"     464";" 2169687";" 2123884";"   45803";" 2155708";" 2119035";"   36673";" 4325395";" 3016712";" 2544606";"  472106";" 1308683";"  203598";"   56669";"   49919";"    6224";"   53977";"   36809";"  619611";"  400208";"  113575";"  105828";"  485474";"  171160";"  146868";"  167446";"       0";"       0";"       0"
"Amsterdam Airport Schiphol";"2015 December";"   35520";"     315";"   17313";"   16895";"     418";"   17296";"   16850";"     446";" 2116536";" 2082771";"   33765";" 2171057";" 2134209";"   36848";" 4287593";" 2916811";" 2447820";"  468991";" 1370782";"  212138";"   54614";"   52493";"    7990";"   58347";"   38694";"  656486";"  418629";"  121675";"  116182";"  502158";"  185041";"  161434";"  155683";"       0";"       0";"       0"
"Amsterdam Airport Schiphol";"2016 January";"   34003";"     352";"   16567";"   16176";"     391";"   16584";"   16197";"     387";" 2067977";" 2033010";"   34967";" 2040843";" 2009059";"   31784";" 4108820";" 2745595";" 2297387";"  448208";" 1363225";"  211744";"   50114";"   55187";"    7668";"   60214";"   38561";"  634604";"  384878";"  126959";"  122767";"  516877";"  177586";"  163095";"  176196";"       0";"       0";"       0"
"Amsterdam Airport Schiphol";"2016 February";"   33832";"     385";"   16478";"   16082";"     396";"   16481";"   16074";"     407";" 2024205";" 1990387";"   33818";" 2071200";" 2037525";"   33675";" 4095405";" 2880353";" 2423626";"  456727";" 1215052";"  194933";"   47166";"   49903";"    7105";"   54956";"   35803";"  550982";"  330153";"  115781";"  105048";"  469137";"  168834";"  137090";"  163213";"       0";"       0";"       0"
"Amsterdam Airport Schiphol";"2016 March";"   37962";"     475";"   18447";"   18009";"     438";"   18456";"   18002";"     454";" 2397134";" 2360183";"   36951";" 2348735";" 2311190";"   37545";" 4745869";" 3326928";" 2803110";"  523818";" 1418941";"  214019";"   57912";"   52728";"    7147";"   58481";"   37751";"  679550";"  444948";"  122567";"  112035";"  525372";"  197696";"  149813";"  177863";"       0";"       0";"       0"
"Amsterdam Airport Schiphol";"2016 April";"   40914";"     443";"   19885";"   19194";"     691";"   19895";"   19207";"     688";" 2545683";" 2489948";"   55735";" 2697790";" 2610588";"   87202";" 5243473";" 3736412";" 3137158";"  599254";" 1507061";"  195376";"   56559";"   49746";"    6036";"   49614";"   33421";"  765587";"  537697";"  117236";"  110654";"  546098";"  196947";"  154080";"  195071";"       0";"       0";"       0"
"Amsterdam Airport Schiphol";"2016 May";"   44671";"     568";"   21719";"   20659";"    1060";"   21700";"   20603";"    1097";" 2913429";" 2766387";"  147042";" 2818577";" 2668713";"  149864";" 5732006";" 4195512";" 3513728";"  681784";" 1536494";"  190193";"   56563";"   39970";"    7901";"   53260";"   32499";"  820679";"  593176";"  118044";"  109459";"  525622";"  186586";"  151323";"  187713";"       0";"       0";"       0"
"Amsterdam Airport Schiphol";"2016 June";"   43613";"     520";"   21208";"   20283";"     925";"   21210";"   20247";"     963";" 2872561";" 2748615";"  123946";" 2864278";" 2736268";"  128010";" 5736839";" 4189124";" 3535693";"  653431";" 1547715";"  177684";"   40988";"   39780";"    7629";"   57831";"   31456";"  831150";"  603626";"  116614";"  110910";"  538881";"  174390";"  154331";"  210160";"       0";"       0";"       0"
"Amsterdam Airport Schiphol";"2016 July";"   46406";"     510";"   22620";"   21283";"    1337";"   22640";"   21347";"    1293";" 2995564";" 2825423";"  170141";" 3375244";" 3166554";"  208690";" 6370808";" 4578516";" 3808166";"  770350";" 1792292";"  240360";"   85936";"   44824";"    9404";"   64834";"   35362";"  903224";"  632783";"  141475";"  128966";"  648708";"  225401";"  177159";"  246148";"       0";"       0";"       0"
"Amsterdam Airport Schiphol";"2016 August";"   46592";"     475";"   22852";"   21516";"    1336";"   22851";"   21422";"    1429";" 3347204";" 3121792";"  225412";" 3054922";" 2856189";"  198733";" 6402126";" 4572032";" 3779001";"  793031";" 1830094";"  257152";"   96563";"   45751";"   10404";"   67367";"   37067";"  908028";"  642188";"  138256";"  127584";"  664914";"  235578";"  178945";"  250391";"       0";"       0";"       0"
"Amsterdam Airport Schiphol";"2016 September";"   44323";"     541";"   21589";"   20621";"     968";"   21597";"   20570";"    1027";" 2943433";" 2800060";"  143373";" 2923054";" 2789090";"  133964";" 5866487";" 4217956";" 3562720";"  655236";" 1648531";"  213970";"   70143";"   40054";"    8628";"   59376";"   35769";"  848398";"  602732";"  126187";"  119479";"  586163";"  199349";"  164839";"  221975";"       0";"       0";"       0"
"Amsterdam Airport Schiphol";"2016 October";"   44334";"     510";"   21699";"   20871";"     828";"   21690";"   20772";"     918";" 2921833";" 2804902";"  116931";" 2860940";" 2768183";"   92757";" 5782773";" 4148178";" 3484875";"  663303";" 1634595";"  218522";"   64575";"   45682";"    7845";"   62828";"   37592";"  829436";"  574585";"  133566";"  121285";"  586637";"  202260";"  168711";"  215666";"       0";"       0";"       0"
"Amsterdam Airport Schiphol";"2016 November";"   37289";"     459";"   18165";"   17765";"     400";"   18160";"   17734";"     426";" 2353958";" 2310685";"   43273";" 2340154";" 2301566";"   38588";" 4694112";" 3286965";" 2791429";"  495536";" 1407147";"  211548";"   54192";"   53816";"    6386";"   56129";"   41025";"  657404";"  414007";"  130314";"  113083";"  538195";"  189631";"  169595";"  178969";"       0";"       0";"       0"
"Amsterdam Airport Schiphol";"2016 December";"   37131";"     368";"   18198";"   17786";"     412";"   18173";"   17733";"     440";" 2333003";" 2292115";"   40888";" 2414642";" 2371090";"   43552";" 4747645";" 3242654";" 2734762";"  507892";" 1504991";"  225498";"   58056";"   57260";"    7601";"   60538";"   42043";"  711129";"  448810";"  138701";"  123618";"  568364";"  210321";"  174539";"  183504";"       0";"       0";"       0"
"Amsterdam Airport Schiphol";"2017 January";"   36373";"     374";"   17826";"   17368";"     458";"   17837";"   17345";"     492";" 2310862";" 2263724";"   47138";" 2248665";" 2205156";"   43509";" 4559527";" 3060824";" 2572846";"  487978";" 1498703";"  225715";"   55561";"   57671";"    7124";"   61396";"   43963";"  684200";"  415992";"  142773";"  125435";"  588788";"  211757";"  181368";"  195663";"       0";"       0";"       0"
"Amsterdam Airport Schiphol";"2017 February";"   34292";"     381";"   16697";"   16292";"     405";"   16703";"   16230";"     473";" 2129390";" 2085722";"   43668";" 2194882";" 2148121";"   46761";" 4324272";" 3013325";" 2541735";"  471590";" 1310947";"  203953";"   49387";"   53306";"    6542";"   56220";"   38498";"  581488";"  347868";"  125984";"  107636";"  525506";"  190369";"  157063";"  178074";"       0";"       0";"       0"
"Amsterdam Airport Schiphol";"2017 March";"   40468";"     519";"   19713";"   19232";"     481";"   19723";"   19204";"     519";" 2622918";" 2572030";"   50888";" 2538306";" 2489061";"   49245";" 5161224";" 3625271";" 3067077";"  558194";" 1535953";"  227072";"   60459";"   57530";"    7119";"   59109";"   42855";"  720334";"  465218";"  137764";"  117352";"  588547";"  216506";"  167836";"  204205";"       0";"       0";"       0"
"Amsterdam Airport Schiphol";"2017 April";"   42894";"     518";"   20936";"   20183";"     753";"   20937";"   20158";"     779";" 2859626";" 2779869";"   79757";" 2977599";" 2867227";"  110372";" 5837225";" 4146176";" 3501837";"  644339";" 1691049";"  222355";"   67994";"   53730";"    6235";"   54071";"   40325";"  865902";"  602264";"  142553";"  121085";"  602792";"  221739";"  161291";"  219762";"       0";"       0";"       0"
"Amsterdam Airport Schiphol";"2017 May";"   46630";"     482";"   22714";"   21687";"    1027";"   22704";"   21637";"    1067";" 3134261";" 2982077";"  152184";" 3073690";" 2921496";"  152194";" 6207951";" 4502206";" 3816377";"  685829";" 1705745";"  201717";"   57059";"   45833";"    7974";"   52615";"   38236";"  912406";"  652156";"  138577";"  121673";"  591622";"  202338";"  159184";"  230100";"       0";"       0";"       0"
"Amsterdam Airport Schiphol";"2017 June";"   45193";"     419";"   22003";"   21012";"     991";"   22008";"   20982";"    1026";" 3087275";" 2940775";"  146500";" 3057500";" 2908191";"  149309";" 6144775";" 4462101";" 3780026";"  682075";" 1682674";"  191099";"   39760";"   45067";"    8662";"   61381";"   36229";"  909338";"  656140";"  136005";"  117193";"  582237";"  191349";"  162263";"  228625";"       0";"       0";"       0"
"Amsterdam Airport Schiphol";"2017 July";"   47602";"     432";"   23241";"   21700";"    1541";"   23254";"   21696";"    1558";" 3182386";" 2969260";"  213126";" 3546888";" 3286082";"  260806";" 6729274";" 4863967";" 4065720";"  798247";" 1865307";"  252660";"   82911";"   48495";"    9042";"   72047";"   40165";"  952462";"  673050";"  149944";"  129468";"  660185";"  242016";"  174189";"  243980";"       0";"       0";"       0"
"Amsterdam Airport Schiphol";"2017 August";"   47755";"     480";"   23432";"   21805";"    1627";"   23431";"   21773";"    1658";" 3520949";" 3240196";"  280753";" 3267719";" 3016178";"  251541";" 6788668";" 4904378";" 4073547";"  830831";" 1884290";"  265226";"   98539";"   48355";"    8783";"   68096";"   41453";"  958942";"  682603";"  145887";"  130452";"  660122";"  246512";"  174183";"  239427";"       0";"       0";"       0"
"Amsterdam Airport Schiphol";"2017 September";"   45392";"     457";"   22133";"   20956";"    1177";"   22136";"   20934";"    1202";" 3160005";" 2973626";"  186379";" 3098276";" 2931442";"  166834";" 6258281";" 4527676";" 3816494";"  711182";" 1730605";"  227513";"   70095";"   47440";"    7580";"   63212";"   39186";"  889357";"  631746";"  132478";"  125133";"  613735";"  214627";"  167095";"  232013";"       0";"       0";"       0"
"Amsterdam Airport Schiphol";"2017 October";"   45957";"     442";"   22426";"   21453";"     973";"   22423";"   21391";"    1032";" 3140562";" 2991662";"  148900";" 3102346";" 2985636";"  116710";" 6242908";" 4512232";" 3798584";"  713648";" 1730676";"  246879";"   76421";"   56485";"    6712";"   64357";"   42904";"  859618";"  597935";"  136262";"  125421";"  624179";"  220567";"  170520";"  233092";"       0";"       0";"       0"
"Amsterdam Airport Schiphol";"2017 November";"   39037";"     476";"   18983";"   18638";"     345";"   18980";"   18585";"     395";" 2597443";" 2558038";"   39405";" 2573314";" 2536543";"   36771";" 5170757";" 3643001";" 3096871";"  546130";" 1527756";"  241642";"   63802";"   61157";"    6822";"   65529";"   44332";"  708793";"  448065";"  141890";"  118838";"  577321";"  194575";"  183500";"  199246";"       0";"       0";"       0"
"Amsterdam Airport Schiphol";"2017 December";"   37324";"     404";"   18259";"   17843";"     416";"   18240";"   17811";"     429";" 2438150";" 2398904";"   39246";" 2537375";" 2495308";"   42067";" 4975525";" 3387426";" 2859205";"  528221";" 1588099";"  251478";"   64991";"   65106";"    7966";"   68194";"   45221";"  746677";"  468071";"  152098";"  126508";"  589944";"  202452";"  197469";"  190023";"       0";"       0";"       0"
"Amsterdam Airport Schiphol";"2018 January";"   37971";"     399";"   18551";"   18123";"     428";"   18562";"   18098";"     464";" 2477411";" 2434350";"   43061";" 2431578";" 2390794";"   40784";" 4908989";" 3322876";" 2792907";"  529969";" 1586113";"  253991";"   61859";"   68379";"    7623";"   71796";"   44334";"  733448";"  439423";"  159102";"  134923";"  598674";"  198863";"  200566";"  199245";"       0";"       0";"       0"
"Amsterdam Airport Schiphol";"2018 February";"   35948";"     461";"   17535";"   17166";"     369";"   17534";"   17103";"     431";" 2333281";" 2293973";"   39308";" 2408525";" 2366715";"   41810";" 4741806";" 3316805";" 2802166";"  514639";" 1425001";"  227227";"   55921";"   60380";"    6733";"   64219";"   39974";"  641702";"  376979";"  143252";"  121471";"  556072";"  182629";"  180872";"  192571";"       0";"       0";"       0"
"Amsterdam Airport Schiphol";"2018 March";"   41220";"     455";"   20019";"   19579";"     440";"   20040";"   19575";"     465";" 2817115";" 2772650";"   44465";" 2742341";" 2697384";"   44957";" 5559456";" 3886460";" 3292053";"  594407";" 1672996";"  257361";"   71951";"   64794";"    6788";"   70100";"   43728";"  795271";"  511992";"  150881";"  132398";"  620364";"  212990";"  191275";"  216099";"       0";"       0";"       0"
"Amsterdam Airport Schiphol";"2018 April";"   42901";"     448";"   20933";"   20238";"     695";"   20928";"   20249";"     679";" 2934838";" 2863160";"   71678";" 3082077";" 2984604";"   97473";" 6016915";" 4247799";" 3591583";"  656216";" 1769116";"  238004";"   73919";"   56906";"    5551";"   57896";"   43732";"  903740";"  632932";"  139769";"  131039";"  627372";"  217204";"  176696";"  233472";"       0";"       0";"       0"
"Amsterdam Airport Schiphol";"2018 May";"   45892";"     507";"   22368";"   21366";"    1002";"   22374";"   21351";"    1023";" 3236091";" 3088356";"  147735";" 3157845";" 3005886";"  151959";" 6393936";" 4617220";" 3895133";"  722087";" 1776716";"  217560";"   61622";"   48918";"    7162";"   57734";"   42124";"  962691";"  691099";"  137073";"  134519";"  596465";"  191259";"  174269";"  230937";"       0";"       0";"       0"
"Amsterdam Airport Schiphol";"2018 June";"   44775";"     503";"   21748";"   20823";"     925";"   21751";"   20826";"     925";" 3192260";" 3059699";"  132561";" 3185133";" 3047212";"  137921";" 6377393";" 4552594";" 3840755";"  711839";" 1824799";"  221629";"   56424";"   48162";"    7845";"   68184";"   41014";"  991079";"  723555";"  133962";"  133562";"  612091";"  195720";"  178626";"  237745";"       0";"       0";"       0"
"Amsterdam Airport Schiphol";"2018 July";"   46761";"     513";"   22779";"   21649";"    1130";"   22772";"   21668";"    1104";" 3188416";" 3036334";"  152082";" 3576588";" 3394009";"  182579";" 6765004";" 4797829";" 4026378";"  771451";" 1967175";"  264113";"   82347";"   51425";"    8742";"   77168";"   44431";" 1031540";"  741174";"  142610";"  147756";"  671522";"  230359";"  191515";"  249648";"       0";"       0";"       0"
"Amsterdam Airport Schiphol";"2018 August";"   46648";"     447";"   22856";"   21693";"    1163";"   22857";"   21673";"    1184";" 3526769";" 3334833";"  191936";" 3309899";" 3127584";"  182315";" 6836668";" 4820950";" 4028082";"  792868";" 2015718";"  279210";"   98140";"   52748";"    9003";"   74350";"   44969";" 1044614";"  755913";"  142665";"  146036";"  691894";"  244056";"  191120";"  256718";"       0";"       0";"       0"
"Amsterdam Airport Schiphol";"2018 September";"   45341";"     443";"   22101";"   21139";"     962";"   22097";"   21113";"     984";" 3212601";" 3066366";"  146235";" 3184339";" 3043433";"  140906";" 6396940";" 4563606";" 3835449";"  728157";" 1833334";"  240643";"   73549";"   50866";"    7835";"   64895";"   43498";"  969446";"  696027";"  131439";"  141980";"  623245";"  202974";"  180637";"  239634";"       0";"       0";"       0"
"Amsterdam Airport Schiphol";"2018 October";"   46170";"     539";"   22549";"   21717";"     832";"   22551";"   21673";"     878";" 3211073";" 3089665";"  121408";" 3191217";" 3096101";"   95116";" 6402290";" 4562671";" 3826613";"  736058";" 1839619";"  261075";"   77026";"   60275";"    6774";"   71122";"   45878";"  942167";"  660868";"  141800";"  139499";"  636377";"  208226";"  186368";"  241783";"       0";"       0";"       0"
"Amsterdam Airport Schiphol";"2018 November";"   39363";"     534";"   19193";"   18842";"     351";"   19189";"   18837";"     352";" 2657363";" 2624650";"   32713";" 2639580";" 2607926";"   31654";" 5296943";" 3700208";" 3153475";"  546733";" 1596735";"  244210";"   65974";"   59319";"    6953";"   67643";"   44321";"  770229";"  497467";"  140476";"  132286";"  582296";"  185732";"  189625";"  206939";"       0";"       0";"       0"
"Amsterdam Airport Schiphol";"2018 December";"   39038";"     457";"   19084";"   18719";"     365";"   19073";"   18703";"     370";" 2573846";" 2542715";"   31131";" 2686408";" 2652013";"   34395";" 5260254";" 3590638";" 3048012";"  542626";" 1669616";"  251163";"   66811";"   62358";"    7445";"   70521";"   44028";"  816561";"  519102";"  153675";"  143784";"  601892";"  200158";"  202731";"  199003";"       0";"       0";"       0"
"Amsterdam Airport Schiphol";"2019 January";"   38009";"     515";"   18588";"   18241";"     347";"   18597";"   18249";"     348";" 2520292";" 2487385";"   32907";" 2475839";" 2443892";"   31947";" 4996131";" 3373101";" 2856935";"  516166";" 1623030";"  251099";"   65528";"   63481";"    7115";"   72596";"   42379";"  771225";"  462521";"  163260";"  145444";"  600706";"  197945";"  198530";"  204231";"       0";"       0";"       0"
"Amsterdam Airport Schiphol";"2019 February";"   36127";"     434";"   17590";"   17378";"     212";"   17605";"   17390";"     215";" 2386195";" 2372975";"   13220";" 2450137";" 2436148";"   13989";" 4836332";" 3383286";" 2874499";"  508787";" 1453046";"  222215";"   61188";"   51236";"    6866";"   63531";"   39394";"  678346";"  401645";"  145265";"  131436";"  552485";"  190308";"  171647";"  190530";"       0";"       0";"       0"
"Amsterdam Airport Schiphol";"2019 March";"   40748";"     534";"   19897";"   19706";"     191";"   19888";"   19698";"     190";" 2847589";" 2837869";"    9720";" 2782725";" 2774073";"    8652";" 5630314";" 3947789";" 3361481";"  586308";" 1682525";"  242485";"   72829";"   56000";"    7125";"   63670";"   42861";"  835790";"  543295";"  153256";"  139239";"  604250";"  215944";"  178766";"  209540";"       0";"       0";"       0"
"Amsterdam Airport Schiphol";"2019 April";"   42976";"     564";"   20940";"   20621";"     319";"   20952";"   20704";"     248";" 2983771";" 2971595";"   12176";" 3120239";" 3100810";"   19429";" 6104010";" 4314805";" 3657659";"  657146";" 1789205";"  234673";"   77102";"   49749";"    6636";"   56495";"   44691";"  936294";"  660685";"  141074";"  134535";"  618238";"  223839";"  153991";"  240408";"       0";"       0";"       0"
"Amsterdam Airport Schiphol";"2019 May";"   45990";"     521";"   22352";"   21979";"     373";"   22354";"   21958";"     396";" 3236047";" 3201298";"   34749";" 3205426";" 3165848";"   39578";" 6441473";" 4651471";" 3931201";"  720270";" 1790002";"  209237";"   54913";"   45509";"    7951";"   57177";"   43687";"  997494";"  726649";"  138900";"  131945";"  583271";"  199898";"  132977";"  250396";"       0";"       0";"       0"
"Amsterdam Airport Schiphol";"2019 June";"   44742";"     505";"   21676";"   21325";"     351";"   21672";"   21336";"     336";" 3273870";" 3238290";"   35580";" 3228718";" 3190237";"   38481";" 6502588";" 4652003";" 3931186";"  720817";" 1850585";"  228331";"   65839";"   44209";"    8549";"   66581";"   43153";" 1027668";"  762961";"  134721";"  129986";"  594586";"  214493";"  130830";"  249263";"       0";"       0";"       0"
"Amsterdam Airport Schiphol";"2019 July";"   45936";"     492";"   22366";"   21937";"     429";"   22370";"   21969";"     401";" 3166610";" 3127298";"   39312";" 3557413";" 3505673";"   51740";" 6724023";" 4758165";" 3992902";"  765263";" 1965858";"  254773";"   79437";"   46725";"    9217";"   74037";"   45357";" 1064565";"  777044";"  142481";"  145040";"  646520";"  243180";"  140403";"  262937";"       0";"       0";"       0"
"Amsterdam Airport Schiphol";"2019 August";"   46167";"     483";"   22558";"   22139";"     419";"   22564";"   22126";"     438";" 3523240";" 3470359";"   52881";" 3287519";" 3234095";"   53424";" 6810759";" 4804762";" 4007196";"  797566";" 2005997";"  265412";"   88852";"   46264";"    8845";"   74963";"   46488";" 1080202";"  793609";"  143389";"  143204";"  660383";"  251293";"  144489";"  264601";"       0";"       0";"       0"
"Amsterdam Airport Schiphol";"2019 September";"   45302";"     456";"   22075";"   21677";"     398";"   22056";"   21641";"     415";" 3252568";" 3215636";"   36932";" 3240900";" 3202920";"   37980";" 6493468";" 4649227";" 3910988";"  738239";" 1844241";"  239167";"   70998";"   45971";"    7239";"   68768";"   46191";"  998333";"  736288";"  131848";"  130197";"  606741";"  214544";"  137525";"  254672";"       0";"       0";"       0"
"Amsterdam Airport Schiphol";"2019 October";"   45643";"     546";"   22251";"   21970";"     281";"   22251";"   21881";"     370";" 3227860";" 3204241";"   23619";" 3203262";" 3184037";"   19225";" 6431122";" 4604704";" 3865499";"  739205";" 1826418";"  248898";"   75847";"   49117";"    6570";"   68932";"   48432";"  964346";"  684886";"  140033";"  139427";"  613174";"  225690";"  138445";"  249039";"       0";"       0";"       0"
"Amsterdam Airport Schiphol";"2019 November";"   38828";"     494";"   18901";"   18748";"     153";"   18899";"   18760";"     139";" 2668379";" 2663742";"    4637";" 2654927";" 2650634";"    4293";" 5323306";" 3717038";" 3173596";"  543442";" 1606268";"  233782";"   67705";"   52026";"    6502";"   60374";"   47175";"  795614";"  504089";"  150620";"  140905";"  576872";"  211274";"  148528";"  217070";"       0";"       0";"       0"
"Amsterdam Airport Schiphol";"2019 December";"   39257";"     515";"   19213";"   19076";"     137";"   19212";"   19079";"     133";" 2640064";" 2635208";"    4856";" 2746139";" 2740455";"    5684";" 5386203";" 3698397";" 3152275";"  546122";" 1687806";"  242028";"   70033";"   54524";"    7880";"   61255";"   48336";"  855812";"  550494";"  157646";"  147672";"  589966";"  222175";"  158395";"  209396";"       0";"       0";"       0"
"Amsterdam Airport Schiphol";"2020 January*";"   38410";"     468";"   18784";"   18628";"     156";"   18783";"   18635";"     148";" 2561003";" 2554007";"    6996";" 2513770";" 2507339";"    6431";" 5074773";" 3452707";" 2932396";"  520311";" 1622066";"  243533";"   66931";"   56185";"    7493";"   64933";"   47991";"  787734";"  481908";"  159765";"  146061";"  590799";"  216030";"  159427";"  215342";"       0";"       0";"       0"
"Amsterdam Airport Schiphol";"2020 February*";"   35942";"     486";"   17492";"   17301";"     191";"   17487";"   17307";"     180";" 2342660";" 2333809";"    8851";" 2377109";" 2367253";"    9856";" 4719769";" 3330655";" 2828259";"  502396";" 1389114";"  229851";"   67910";"   51026";"    7044";"   58870";"   45001";"  712192";"  423686";"  154658";"  133848";"  447071";"  201699";"  141678";"  103694";"       0";"       0";"       0"
"Amsterdam Airport Schiphol";"2020 March*";"   25883";"     529";"   12626";"   12425";"     201";"   12529";"   12194";"     335";" 1298133";" 1289921";"    8212";" 1178239";" 1173791";"    4448";" 2476372";" 1641935";" 1387274";"  254661";"  834437";"  145163";"   39428";"   33009";"    3890";"   36374";"   32462";"  436831";"  243685";"  105520";"   87626";"  252443";"  110189";"   97016";"   45238";"       0";"       0";"       0"
"Amsterdam Airport Schiphol";"2020 April*";"    4583";"     371";"    2118";"    1919";"     199";"    2118";"    1931";"     187";"   70038";"   68132";"    1906";"   55977";"   55125";"     852";"  126015";"   67687";"   55435";"   12252";"   58328";"    2875";"     641";"     266";"     139";"     271";"    1558";"   30099";"   20466";"    4611";"    5022";"   24851";"    6143";"    9379";"    9329";"     503";"       0";"       0"
"Amsterdam Airport Schiphol";"2020 May*";"    6347";"     403";"    2930";"    2634";"     296";"    2943";"    2645";"     298";"  109314";"  106649";"    2665";"   98513";"   96713";"    1800";"  207827";"  131546";"  110706";"   20840";"   76281";"    3741";"    2230";"     442";"      99";"     275";"     695";"   42055";"   27209";"    5892";"    8954";"   30485";"    5066";"   11729";"   13690";"       0";"       0";"       0"
"Amsterdam Airport Schiphol";"2020 June*";"    8797";"     422";"    4057";"    3802";"     255";"    4051";"    3817";"     234";"  229128";"  227131";"    1997";"  242282";"  236949";"    5333";"  471410";"  338245";"  270952";"   67293";"  133165";"    7540";"    1374";"     798";"     538";"     996";"    3834";"   74685";"   52137";"    9162";"   13386";"   50940";"   10856";"   21433";"   18651";"       0";"       0";"       0"
"Amsterdam Airport Schiphol";"2020 July*";"   16789";"     430";"    7831";"    7550";"     281";"    7871";"    7620";"     251";"  608849";"  602613";"    6236";"  730008";"  718473";"   11535";" 1338857";" 1114398";"  938685";"  175713";"  224459";"   21975";"   11255";"    1781";"      45";"    4425";"    4469";"  124208";"   72435";"   37122";"   14651";"   78276";"   26724";"   25566";"   25986";"       0";"       0";"       0"
"Amsterdam Airport Schiphol";"2020 August*";"   24093";"     519";"   11545";"   11319";"     226";"   11580";"   11352";"     228";"  983983";"  974423";"    9560";"  870803";"  862194";"    8609";" 1854786";" 1608511";" 1366505";"  242006";"  246275";"   24178";"    7122";"    1573";"    1120";"    9960";"    4403";"  147032";"   78145";"   49609";"   19278";"   75065";"   27925";"   17882";"   29258";"       0";"       0";"       0"
"Amsterdam Airport Schiphol";"2020 September*";"   23046";"     442";"   11087";"   10897";"     190";"   11075";"   10867";"     208";"  684061";"  676889";"    7172";"  653680";"  648517";"    5163";" 1337741";" 1102721";"  937298";"  165423";"  235020";"   29625";"   10066";"    6958";"    1015";"    8719";"    2867";"  132894";"   66307";"   44523";"   22064";"   72501";"   24604";"   16689";"   31208";"       0";"       0";"       0"
"Amsterdam Airport Schiphol";"2020 October*";"   20306";"     378";"    9801";"    9657";"     144";"    9813";"    9666";"     147";"  576128";"  572385";"    3743";"  567355";"  564149";"    3206";" 1143483";"  874489";"  729708";"  144781";"  268994";"   46151";"   16735";"    8490";"    1366";"   13777";"    5783";"  146461";"   66842";"   55488";"   24131";"   76382";"   30709";"   17506";"   28167";"       0";"       0";"       0"
"Amsterdam Airport Schiphol";"2020 November*";"   15382";"     402";"    7433";"    7166";"     267";"    7425";"    7156";"     269";"  451046";"  449639";"    1407";"  449388";"  447608";"    1780";"  900434";"  629150";"  503689";"  125461";"  271284";"   45128";"   12779";"    8603";"    1344";"   13427";"    8975";"  154035";"   66435";"   62803";"   24797";"   72121";"   29950";"   22493";"   19678";"       0";"       0";"       0"
"Amsterdam Airport Schiphol";"2020 December*";"   16576";"     397";"    7956";"    7518";"     438";"    7940";"    7643";"     297";"  580297";"  578414";"    1883";"  652746";"  650574";"    2172";" 1233043";"  836069";"  685753";"  150316";"  396974";"   79232";"   24375";"   15922";"    2209";"   20942";"   15784";"  227504";"  103297";"   76657";"   47550";"   90238";"   44781";"   25330";"   20127";"       0";"       0";"       0"
"Amsterdam Airport Schiphol";"2021 January*";"   15181";"     458";"    7317";"    7085";"     232";"    7349";"    7140";"     209";"  463793";"  462271";"    1522";"  405336";"  404153";"    1183";"  869129";"  553464";"  396818";"  156646";"  315665";"   63849";"   17691";"   14618";"    1708";"   19003";"   10829";"  174464";"   82135";"   58028";"   34301";"   77352";"   37553";"   22350";"   17449";"       0";"       0";"       0"
"Amsterdam Airport Schiphol";"2021 February*";"   11083";"     409";"    5328";"    5071";"     257";"    5327";"    5102";"     225";"  253143";"  252115";"    1028";"  252051";"  251249";"     802";"  505194";"  327631";"  256374";"   71257";"  177563";"   35977";"   13126";"    6893";"     803";"   13061";"    2094";"   88342";"   35111";"   41780";"   11451";"   53244";"   24888";"   18262";"   10094";"       0";"       0";"       0"
"Amsterdam Airport Schiphol";"2021 March*";"   12905";"     466";"    6112";"    5837";"     275";"    6105";"    5819";"     286";"  331608";"  330707";"     901";"  328568";"  327349";"    1219";"  660176";"  430955";"  319392";"  111563";"  229221";"   36634";"    4694";"   11017";"    1379";"   14671";"    4873";"  123707";"   48381";"   53803";"   21523";"   68880";"   31593";"   22014";"   15273";"       0";"       0";"       0"
"Amsterdam Airport Schiphol";"2021 April*";"   14489";"     402";"    6855";"    6618";"     237";"    6865";"    6636";"     229";"  386810";"  386367";"     443";"  399842";"  399386";"     456";"  786652";"  536128";"  382479";"  153649";"  250524";"   42789";"    5635";"   14411";"    1588";"   14769";"    6386";"  128293";"   59973";"   41933";"   26387";"   79442";"   38019";"   21444";"   19979";"       0";"       0";"       0"
"Amsterdam Airport Schiphol";"2021 May*";"   16628";"     439";"    7790";"    7610";"     180";"    7786";"    7610";"     176";"  552079";"  551336";"     743";"  554661";"  553428";"    1233";" 1106740";"  804575";"  608518";"  196057";"  302165";"   49758";"    5975";"   14652";"    2419";"   18154";"    8558";"  169040";"   90218";"   54549";"   24273";"   83367";"   40749";"   21106";"   21512";"       0";"       0";"       0"
"Amsterdam Airport Schiphol";"2021 June*";"   20494";"     466";"    9593";"    9395";"     198";"    9602";"    9406";"     196";"  816099";"  810455";"    5644";"  862166";"  855898";"    6268";" 1678265";" 1231479";"  966229";"  265250";"  446786";"   77058";"   20564";"   17492";"    2947";"   24768";"   11287";"  269639";"  152456";"   80783";"   36400";"  100089";"   47623";"   26362";"   26104";"       0";"       0";"       0"
"Amsterdam Airport Schiphol";"2021 July*";"   30496";"     390";"   14563";"   14284";"     279";"   14578";"   14293";"     285";" 1378580";" 1366523";"   12057";" 1651371";" 1634388";"   16983";" 3029951";" 2303289";" 1817411";"  485878";"  726662";"  138555";"   66288";"   23884";"    3148";"   33409";"   11826";"  442554";"  250840";"  140466";"   51248";"  145553";"   82938";"   31657";"   30958";"       0";"       0";"       0"
"Amsterdam Airport Schiphol";"2021 August*";"   33118";"     430";"   15929";"   15627";"     302";"   15918";"   15595";"     323";" 2002462";" 1977813";"   24649";" 1784511";" 1762959";"   21552";" 3786973";" 2939403";" 2300080";"  639323";"  847570";"  156726";"   80943";"   23520";"    3328";"   36716";"   12219";"  522054";"  301725";"  154481";"   65848";"  168790";"   99406";"   33806";"   35578";"       0";"       0";"       0"
"Amsterdam Airport Schiphol";"2021 September*";"   31820";"     538";"   15009";"   14720";"     289";"   15010";"   14711";"     299";" 1718856";" 1698506";"   20350";" 1651349";" 1632911";"   18438";" 3370205";" 2677291";" 2080979";"  596312";"  692914";"  118090";"   44148";"   23202";"    3005";"   34362";"   13373";"  435718";"  241557";"  120547";"   73614";"  139106";"   75464";"   30401";"   33241";"       0";"       0";"       0"
"Amsterdam Airport Schiphol";"2021 October*";"   33037";"     428";"   15655";"   15418";"     237";"   15669";"   15371";"     298";" 1907661";" 1896597";"   11064";" 1838330";" 1829709";"    8621";" 3745991";" 2978808";" 2204098";"  774710";"  767183";"  118666";"   31886";"   25769";"    3376";"   37549";"   20086";"  475162";"  234121";"  148366";"   92675";"  173355";"  104283";"   37117";"   31955";"       0";"       0";"       0"
"Amsterdam Airport Schiphol";"2021 November*";"   29730";"     394";"   14195";"   13971";"     224";"   14176";"   13942";"     234";" 1551581";" 1548558";"    3023";" 1544242";" 1541671";"    2571";" 3095823";" 2273366";" 1590431";"  682935";"  822457";"  116795";"   18036";"   32834";"    3721";"   37766";"   24438";"  518786";"  254593";"  164111";"  100082";"  186876";"  112633";"   47219";"   27024";"       0";"       0";"       0"
"Amsterdam Airport Schiphol";"2021 December*";"   31358";"     423";"   15120";"   14897";"     223";"   15105";"   14896";"     209";" 1329625";" 1325248";"    4377";" 1526086";" 1519602";"    6484";" 2855711";" 1924693";" 1369691";"  555002";"  931018";"  122891";"   22474";"   38592";"    3520";"   37607";"   20698";"  593224";"  310974";"  177547";"  104703";"  214903";"  128246";"   60260";"   26397";"       0";"       0";"       0"
"Amsterdam Airport Schiphol";"2022 January*";"   27131";"     476";"   13099";"   12937";"     162";"   13132";"   12968";"     164";" 1334253";" 1326755";"    7498";" 1153830";" 1146412";"    7418";" 2488083";" 1664713";" 1180918";"  483795";"  823370";"  123579";"   19715";"   36233";"    2778";"   40535";"   24318";"  522154";"  234824";"  182605";"  104725";"  177637";"  101785";"   53922";"   21930";"       0";"       0";"       0"
"Amsterdam Airport Schiphol";"2022 February*";"   25198";"     333";"   12070";"   11871";"     199";"   12059";"   11872";"     187";" 1311499";" 1303280";"    8219";" 1349177";" 1340656";"    8521";" 2660676";" 1905321";" 1334191";"  571130";"  755355";"  120084";"   28837";"   28639";"    2459";"   34753";"   25396";"  455413";"  191060";"  161686";"  102667";"  179858";"  112424";"   50494";"   16940";"       0";"       0";"       0"
"Amsterdam Airport Schiphol";"2022 March*";"   31821";"     455";"   15200";"   14935";"     265";"   15182";"   14974";"     208";" 1911518";" 1902281";"    9237";" 1820530";" 1813168";"    7362";" 3732048";" 2706725";" 1865976";"  840749";" 1025323";"  150522";"   41401";"   34555";"    3163";"   38337";"   33066";"  632949";"  333806";"  178404";"  120739";"  241852";"  156282";"   68398";"   17172";"       0";"       0";"       0"
"Amsterdam Airport Schiphol";"2022 April*";"   35035";"     494";"   16680";"   16302";"     378";"   16741";"   16450";"     291";" 2141978";" 2123379";"   18599";" 2292609";" 2260711";"   31898";" 4434587";" 3252399";" 2222148";" 1030251";" 1182188";"  160086";"   37546";"   40773";"    3116";"   39827";"   38824";"  766641";"  480869";"  156643";"  129129";"  255461";"  154179";"   79427";"   21855";"       0";"       0";"       0"
"Amsterdam Airport Schiphol";"2022 May*";"   40208";"     478";"   19205";"   18668";"     537";"   19214";"   18696";"     518";" 2674745";" 2615015";"   59730";" 2542290";" 2480921";"   61369";" 5217035";" 3891004";" 2692816";" 1198188";" 1326031";"  168827";"   50612";"   37188";"    4939";"   41689";"   34399";"  861886";"  580872";"  150821";"  130193";"  295318";"  167706";"  101792";"   25820";"       0";"       0";"       0"
"Amsterdam Airport Schiphol";"2022 June*";"   39103";"     475";"   18463";"   17924";"     539";"   18456";"   17991";"     465";" 2630931";" 2572383";"   58548";" 2601699";" 2536653";"   65046";" 5232630";" 3807896";" 2623208";" 1184688";" 1424734";"  181674";"   52544";"   41361";"    5125";"   47889";"   34755";"  938211";"  676303";"  137808";"  124100";"  304849";"  164309";"  112717";"   27823";"       0";"       0";"       0"
"Amsterdam Airport Schiphol";"2022 July*";"   38012";"     531";"   17982";"   17478";"     504";"   18018";"   17588";"     430";" 2484720";" 2436393";"   48327";" 2695005";" 2632258";"   62747";" 5179725";" 3615230";" 2532730";" 1082500";" 1564495";"  205667";"   57859";"   43331";"    6446";"   56975";"   41056";"  999352";"  691674";"  172520";"  135158";"  359476";"  197243";"  125850";"   36383";"       0";"       0";"       0"
"Amsterdam Airport Schiphol";"2022 August*";"   39284";"     535";"   18861";"   18406";"     455";"   18869";"   18405";"     464";" 2790696";" 2728793";"   61903";" 2536665";" 2478441";"   58224";" 5327361";" 3743746";" 2619575";" 1124171";" 1583615";"  226753";"   74170";"   45443";"    5824";"   60025";"   41291";"  988004";"  682271";"  169522";"  136211";"  368858";"  207584";"  121306";"   39968";"       0";"       0";"       0"
"Amsterdam Airport Schiphol";"2022 September*";"   39029";"     542";"   18518";"   18133";"     385";"   18509";"   18090";"     419";" 2627876";" 2580505";"   47371";" 2569055";" 2522755";"   46300";" 5196931";" 3705504";" 2549113";" 1156391";" 1491427";"  206825";"   58834";"   43417";"    5146";"   58726";"   40702";"  929705";"  648794";"  143954";"  136957";"  354897";"  194317";"  117274";"   43306";"       0";"       0";"       0"
"Amsterdam Airport Schiphol";"2022 October*";"   38087";"     597";"   18189";"   17824";"     365";"   18172";"   17683";"     489";" 2489573";" 2445462";"   44111";" 2422848";" 2388200";"   34648";" 4912421";" 3443474";" 2333504";" 1109970";" 1468947";"  213876";"   63664";"   43707";"    5921";"   59995";"   40589";"  899342";"  599749";"  159460";"  140133";"  355729";"  196436";"  118928";"   40365";"       0";"       0";"       0"
"Amsterdam Airport Schiphol";"2022 November*";"   31672";"     468";"   15178";"   15023";"     155";"   15170";"   15031";"     139";" 2009494";" 1996721";"   12773";" 1977911";" 1968274";"    9637";" 3987405";" 2692949";" 1775754";"  917195";" 1294456";"  203962";"   63311";"   44692";"    3418";"   53320";"   39221";"  720012";"  435259";"  165846";"  118907";"  370482";"  189969";"  134991";"   45522";"       0";"       0";"       0"
"Rotterdam The Hague Airport";"1999 January";"    2662";"    4184";"     794";"     692";"     102";"     792";"     692";"     100";"   18051";"   17166";"     885";"   17403";"   16094";"    1309";"   35454";"   34822";"   34538";"     284";"     632";"       0";"       0";"       0";"       0";"       0";"       0";"       0";"       0";"       0";"       0";"       0";"       0";"       0";"       0";"       0";"     632";"       0"
"Rotterdam The Hague Airport";"1999 February";"    2615";"    3974";"     780";"     680";"     100";"     790";"     664";"     126";"   20702";"   18714";"    1988";"   18576";"   17002";"    1574";"   39278";"   38173";"   37628";"     545";"    1105";"       0";"       0";"       0";"       0";"       0";"       0";"       0";"       0";"       0";"       0";"       0";"       0";"       0";"       0";"       0";"    1105";"       0"
"Rotterdam The Hague Airport";"1999 March";"    3594";"    5654";"     939";"     780";"     159";"     936";"     776";"     160";"   20329";"   18480";"    1849";"   19792";"   17815";"    1977";"   40121";"   38543";"   37159";"    1384";"    1578";"       0";"       0";"       0";"       0";"       0";"       0";"       0";"       0";"       0";"       0";"       0";"       0";"       0";"       0";"       0";"    1578";"       0"
"Rotterdam The Hague Airport";"1999 April";"    3444";"    6238";"     870";"     717";"     153";"     862";"     719";"     143";"   18664";"   16031";"    2633";"   21245";"   18420";"    2825";"   39909";"   39414";"   35929";"    3485";"     495";"       0";"       0";"       0";"       0";"       0";"       0";"       0";"       0";"       0";"       0";"       0";"       0";"       0";"       0";"       0";"     495";"       0"
"Rotterdam The Hague Airport";"1999 May";"    4119";"    6196";"     962";"     787";"     175";"     956";"     787";"     169";"   31911";"   28470";"    3441";"   33056";"   29467";"    3589";"   64967";"   64394";"   60919";"    3475";"     573";"       0";"       0";"       0";"       0";"       0";"       0";"       0";"       0";"       0";"       0";"       0";"       0";"       0";"       0";"       0";"     573";"       0"
"Rotterdam The Hague Airport";"1999 June";"    4149";"    6502";"    1024";"     832";"     192";"    1026";"     830";"     196";"   28348";"   27148";"    1200";"   29141";"   27429";"    1712";"   57489";"   56847";"   54890";"    1957";"     642";"       0";"       0";"       0";"       0";"       0";"       0";"       0";"       0";"       0";"       0";"       0";"       0";"       0";"       0";"       0";"     642";"       0"
"Rotterdam The Hague Airport";"1999 July";"    4021";"    6596";"     939";"     763";"     176";"     937";"     769";"     168";"   28780";"   27206";"    1574";"   35405";"   32303";"    3102";"   64185";"   61346";"   59063";"    2283";"    2839";"       0";"       0";"       0";"       0";"       0";"       0";"       0";"       0";"       0";"       0";"       0";"       0";"       0";"       0";"       0";"    2839";"       0"
"Rotterdam The Hague Airport";"1999 August";"    3858";"    6626";"     982";"     803";"     179";"     980";"     802";"     178";"   35062";"   31726";"    3336";"   29618";"   27849";"    1769";"   64680";"   60142";"   56863";"    3279";"    4538";"       0";"       0";"       0";"       0";"       0";"       0";"       0";"       0";"       0";"       0";"       0";"       0";"       0";"       0";"       0";"    4538";"       0"
"Rotterdam The Hague Airport";"1999 September";"    3932";"    6214";"    1068";"     856";"     212";"    1067";"     857";"     210";"   30502";"   28374";"    2128";"   32844";"   29678";"    3166";"   63346";"   62433";"   59087";"    3346";"     913";"       0";"       0";"       0";"       0";"       0";"       0";"       0";"       0";"       0";"       0";"       0";"       0";"       0";"       0";"       0";"     913";"       0"
"Rotterdam The Hague Airport";"1999 October";"    3651";"    5348";"    1055";"     855";"     200";"    1044";"     853";"     191";"   32735";"   28383";"    4352";"   29396";"   25637";"    3759";"   62131";"   61325";"   55623";"    5702";"     806";"       0";"       0";"       0";"       0";"       0";"       0";"       0";"       0";"       0";"       0";"       0";"       0";"       0";"       0";"       0";"     806";"       0"
"Rotterdam The Hague Airport";"1999 November";"    3227";"    4948";"     949";"     812";"     137";"     947";"     809";"     138";"   21246";"   19797";"    1449";"   20487";"   18956";"    1531";"   41733";"   40262";"   39734";"     528";"    1471";"       0";"       0";"       0";"       0";"       0";"       0";"       0";"       0";"       0";"       0";"       0";"       0";"       0";"       0";"       0";"    1471";"       0"
"Rotterdam The Hague Airport";"1999 December";"    2485";"    3398";"     797";"     679";"     118";"     809";"     679";"     130";"   17649";"   16456";"    1193";"   16225";"   15503";"     722";"   33874";"   33407";"   33320";"      87";"     467";"       0";"       0";"       0";"       0";"       0";"       0";"       0";"       0";"       0";"       0";"       0";"       0";"       0";"       0";"       0";"     467";"       0"
"Rotterdam The Hague Airport";"2000 January";"    2888";"    4470";"     904";"     744";"     160";"     899";"     738";"     161";"   17714";"   14070";"    3644";"   17292";"   13423";"    3869";"   35006";"   34095";"   33447";"     648";"     911";"     626";"     626";"       0";"       0";"       0";"       0";"       0";"       0";"       0";"       0";"     285";"       0";"       0";"     285";"       0";"       0";"       0"
"Rotterdam The Hague Airport";"2000 February";"    3220";"    4968";"     921";"     766";"     155";"     921";"     766";"     155";"   19023";"   15253";"    3770";"   19698";"   15829";"    3869";"   38721";"   37819";"   37476";"     343";"     902";"     764";"     764";"       0";"       0";"       0";"       0";"       0";"       0";"       0";"       0";"     138";"     138";"       0";"       0";"       0";"       0";"       0"
"Rotterdam The Hague Airport";"2000 March";"    3587";"    6028";"    1037";"     824";"     213";"    1038";"     825";"     213";"   23657";"   18152";"    5505";"   23100";"   17635";"    5465";"   46757";"   45595";"   44565";"    1030";"    1162";"    1162";"    1162";"       0";"       0";"       0";"       0";"       0";"       0";"       0";"       0";"       0";"       0";"       0";"       0";"       0";"       0";"       0"
"Rotterdam The Hague Airport";"2000 April";"    3954";"    6758";"    1048";"     800";"     248";"    1037";"     803";"     234";"   24727";"   19415";"    5312";"   27578";"   20245";"    7333";"   52305";"   51581";"   48166";"    3415";"     724";"     703";"     703";"       0";"       0";"       0";"       0";"       0";"       0";"       0";"       0";"      21";"      21";"       0";"       0";"       0";"       0";"       0"
"Rotterdam The Hague Airport";"2000 May";"    4367";"    7118";"    1201";"     920";"     281";"    1197";"     915";"     282";"   37706";"   24931";"   12775";"   36895";"   23490";"   13405";"   74601";"   74580";"   70371";"    4209";"      21";"       0";"       0";"       0";"       0";"       0";"       0";"       0";"       0";"       0";"       0";"      21";"      21";"       0";"       0";"       0";"       0";"       0"
"Rotterdam The Hague Airport";"2000 June";"    4605";"    6070";"    1212";"     868";"     344";"    1207";"     857";"     350";"   39820";"   24450";"   15370";"   39609";"   22385";"   17224";"   79429";"   78913";"   69232";"    9681";"     516";"     516";"     516";"       0";"       0";"       0";"       0";"       0";"       0";"       0";"       0";"       0";"       0";"       0";"       0";"       0";"       0";"       0"
"Rotterdam The Hague Airport";"2000 July";"    3948";"    5154";"    1108";"     875";"     233";"    1107";"     875";"     232";"   34157";"   24055";"   10102";"   42948";"   28731";"   14217";"   77105";"   70717";"   65714";"    5003";"    6388";"    6388";"    5828";"     560";"       0";"       0";"       0";"       0";"       0";"       0";"       0";"       0";"       0";"       0";"       0";"       0";"       0";"       0"
"Rotterdam The Hague Airport";"2000 August";"    4029";"    6948";"    1054";"     852";"     202";"    1063";"     843";"     220";"   40384";"   28928";"   11456";"   30686";"   21388";"    9298";"   71070";"   64542";"   58476";"    6066";"    6528";"    6528";"    6174";"     354";"       0";"       0";"       0";"       0";"       0";"       0";"       0";"       0";"       0";"       0";"       0";"       0";"       0";"       0"
"Rotterdam The Hague Airport";"2000 September";"    3950";"    6242";"    1096";"     833";"     263";"    1091";"     828";"     263";"   37672";"   26488";"   11184";"   38581";"   26502";"   12079";"   76253";"   74898";"   68408";"    6490";"    1355";"    1180";"    1180";"       0";"       0";"       0";"       0";"      88";"      88";"       0";"       0";"      87";"      87";"       0";"       0";"       0";"       0";"       0"
"Rotterdam The Hague Airport";"2000 October";"    3538";"    5208";"    1125";"     883";"     242";"    1131";"     878";"     253";"   37688";"   27867";"    9821";"   31625";"   24059";"    7566";"   69313";"   69313";"   64536";"    4777";"       0";"       0";"       0";"       0";"       0";"       0";"       0";"       0";"       0";"       0";"       0";"       0";"       0";"       0";"       0";"       0";"       0";"       0"
"Rotterdam The Hague Airport";"2000 November";"    3053";"    6024";"     962";"     779";"     183";"     958";"     776";"     182";"   21792";"   18548";"    3244";"   20981";"   17618";"    3363";"   42773";"   42773";"   42544";"     229";"       0";"       0";"       0";"       0";"       0";"       0";"       0";"       0";"       0";"       0";"       0";"       0";"       0";"       0";"       0";"       0";"       0";"       0"
"Rotterdam The Hague Airport";"2000 December";"    2543";"    4654";"     743";"     619";"     124";"     746";"     614";"     132";"   16845";"   14448";"    2397";"   16434";"   14065";"    2369";"   33279";"   33279";"   32953";"     326";"       0";"       0";"       0";"       0";"       0";"       0";"       0";"       0";"       0";"       0";"       0";"       0";"       0";"       0";"       0";"       0";"       0";"       0"
"Rotterdam The Hague Airport";"2001 January";"    2938";"    4026";"     898";"     738";"     160";"     897";"     737";"     160";"   17754";"   15134";"    2620";"   17111";"   14645";"    2466";"   34865";"   34865";"   34206";"     659";"       0";"       0";"       0";"       0";"       0";"       0";"       0";"       0";"       0";"       0";"       0";"       0";"       0";"       0";"       0";"       0";"       0";"       0"
"Rotterdam The Hague Airport";"2001 February";"    2750";"    4482";"     808";"     677";"     131";"     806";"     669";"     137";"   17295";"   15015";"    2280";"   17495";"   14717";"    2778";"   34790";"   34790";"   33882";"     908";"       0";"       0";"       0";"       0";"       0";"       0";"       0";"       0";"       0";"       0";"       0";"       0";"       0";"       0";"       0";"       0";"       0";"       0"
"Rotterdam The Hague Airport";"2001 March";"    3210";"    4814";"     937";"     775";"     162";"     942";"     772";"     170";"   21754";"   17236";"    4518";"   21148";"   17050";"    4098";"   42902";"   42862";"   40790";"    2072";"      40";"      40";"      40";"       0";"       0";"       0";"       0";"       0";"       0";"       0";"       0";"       0";"       0";"       0";"       0";"       0";"       0";"       0"
"Rotterdam The Hague Airport";"2001 April";"    3033";"    5786";"     716";"     535";"     181";"     712";"     533";"     179";"   25824";"   20967";"    4857";"   30556";"   22979";"    7577";"   56380";"   56210";"   51946";"    4264";"     170";"      40";"      40";"       0";"       0";"       0";"       0";"       0";"       0";"       0";"       0";"     130";"     130";"       0";"       0";"       0";"       0";"       0"
"Rotterdam The Hague Airport";"2001 May";"    3800";"    6360";"     861";"     595";"     266";"     862";"     595";"     267";"   39981";"   26223";"   13758";"   41763";"   26473";"   15290";"   81744";"   81500";"   73799";"    7701";"     244";"       0";"       0";"       0";"       0";"       0";"       0";"       0";"       0";"       0";"       0";"     244";"     244";"       0";"       0";"       0";"       0";"       0"
"Rotterdam The Hague Airport";"2001 June";"    3715";"    5408";"     898";"     643";"     255";"     902";"     644";"     258";"   38800";"   25745";"   13055";"   38168";"   25308";"   12860";"   76968";"   76050";"   71155";"    4895";"     918";"     748";"     748";"       0";"       0";"       0";"       0";"       0";"       0";"       0";"       0";"     170";"     170";"       0";"       0";"       0";"       0";"       0"
"Rotterdam The Hague Airport";"2001 July";"    3581";"    4546";"     948";"     663";"     285";"     943";"     671";"     272";"   41665";"   24868";"   16797";"   51723";"   31613";"   20110";"   93388";"   86580";"   75659";"   10921";"    6808";"    6559";"    6374";"     185";"       0";"       0";"       0";"       0";"       0";"       0";"       0";"     249";"     249";"       0";"       0";"       0";"       0";"       0"
"Rotterdam The Hague Airport";"2001 August";"    3643";"    4906";"     974";"     684";"     290";"     980";"     680";"     300";"   60189";"   31565";"   28624";"   41477";"   23401";"   18076";"  101666";"   91086";"   77453";"   13633";"   10580";"   10286";"   10101";"     185";"       0";"       0";"       0";"       0";"       0";"       0";"       0";"     294";"     294";"       0";"       0";"       0";"       0";"       0"
"Rotterdam The Hague Airport";"2001 September";"    3243";"    4150";"     928";"     635";"     293";"     924";"     633";"     291";"   44172";"   26037";"   18135";"   40611";"   25023";"   15588";"   84783";"   80756";"   72959";"    7797";"    4027";"    3084";"    3084";"       0";"       0";"       0";"       0";"       0";"       0";"       0";"       0";"     943";"     943";"       0";"       0";"       0";"       0";"       0"
"Rotterdam The Hague Airport";"2001 October";"    3300";"    4566";"     905";"     652";"     253";"     899";"     650";"     249";"   42365";"   25594";"   16771";"   33587";"   23051";"   10536";"   75952";"   75488";"   67198";"    8290";"     464";"       0";"       0";"       0";"       0";"       0";"       0";"       0";"       0";"       0";"       0";"     464";"     464";"       0";"       0";"       0";"       0";"       0"
"Rotterdam The Hague Airport";"2001 November";"    2566";"    3624";"     610";"     486";"     124";"     611";"     486";"     125";"   18804";"   14607";"    4197";"   17805";"   14146";"    3659";"   36609";"   36438";"   35850";"     588";"     171";"       0";"       0";"       0";"       0";"       0";"       0";"       0";"       0";"       0";"       0";"     171";"     171";"       0";"       0";"       0";"       0";"       0"
"Rotterdam The Hague Airport";"2001 December";"    1911";"    2516";"     484";"     397";"      87";"     488";"     398";"      90";"   13525";"   10425";"    3100";"   14255";"   10983";"    3272";"   27780";"   27780";"   27591";"     189";"       0";"       0";"       0";"       0";"       0";"       0";"       0";"       0";"       0";"       0";"       0";"       0";"       0";"       0";"       0";"       0";"       0";"       0"
"Rotterdam The Hague Airport";"2002 January";"    2288";"    2986";"     651";"     527";"     124";"     655";"     522";"     133";"   16646";"   13139";"    3507";"   15709";"   12091";"    3618";"   32355";"   32197";"   31908";"     289";"     158";"     158";"     158";"       0";"       0";"       0";"       0";"       0";"       0";"       0";"       0";"       0";"       0";"       0";"       0";"       0";"       0";"       0"
"Rotterdam The Hague Airport";"2002 February";"    2375";"    2822";"     629";"     506";"     123";"     626";"     509";"     117";"   17448";"   13175";"    4273";"   17832";"   13523";"    4309";"   35280";"   35280";"   34889";"     391";"       0";"       0";"       0";"       0";"       0";"       0";"       0";"       0";"       0";"       0";"       0";"       0";"       0";"       0";"       0";"       0";"       0";"       0"
"Rotterdam The Hague Airport";"2002 March";"    3254";"    5318";"     699";"     551";"     148";"     707";"     551";"     156";"   21658";"   15417";"    6241";"   21002";"   14854";"    6148";"   42660";"   42660";"   41640";"    1020";"       0";"       0";"       0";"       0";"       0";"       0";"       0";"       0";"       0";"       0";"       0";"       0";"       0";"       0";"       0";"       0";"       0";"       0"
"Rotterdam The Hague Airport";"2002 April";"    3123";"    4404";"     708";"     564";"     144";"     719";"     563";"     156";"   22277";"   17971";"    4306";"   25631";"   18938";"    6693";"   47908";"   47908";"   45245";"    2663";"       0";"       0";"       0";"       0";"       0";"       0";"       0";"       0";"       0";"       0";"       0";"       0";"       0";"       0";"       0";"       0";"       0";"       0"
"Rotterdam The Hague Airport";"2002 May";"    3419";"    4538";"     839";"     655";"     184";"     838";"     655";"     183";"   34325";"   22671";"   11654";"   32451";"   20786";"   11665";"   66776";"   66736";"   60105";"    6631";"      40";"       0";"       0";"       0";"       0";"       0";"       0";"      40";"      40";"       0";"       0";"       0";"       0";"       0";"       0";"       0";"       0";"       0"
"Rotterdam The Hague Airport";"2002 June";"    3520";"    5204";"     819";"     584";"     235";"     826";"     586";"     240";"   30312";"   18243";"   12069";"   30567";"   18670";"   11897";"   60879";"   60151";"   54586";"    5565";"     728";"     660";"     660";"       0";"       0";"       0";"       0";"      68";"      68";"       0";"       0";"       0";"       0";"       0";"       0";"       0";"       0";"       0"
"Rotterdam The Hague Airport";"2002 July";"    3416";"    4722";"     817";"     638";"     179";"     825";"     644";"     181";"   29293";"   18776";"   10517";"   37657";"   23284";"   14373";"   66950";"   63083";"   55387";"    7696";"    3867";"    3867";"    3296";"     571";"       0";"       0";"       0";"       0";"       0";"       0";"       0";"       0";"       0";"       0";"       0";"       0";"       0";"       0"
"Rotterdam The Hague Airport";"2002 August";"    3345";"    6414";"     819";"     631";"     188";"     820";"     618";"     202";"   38611";"   24444";"   14167";"   28019";"   17669";"   10350";"   66630";"   61353";"   53488";"    7865";"    5277";"    5277";"    4691";"     586";"       0";"       0";"       0";"       0";"       0";"       0";"       0";"       0";"       0";"       0";"       0";"       0";"       0";"       0"
"Rotterdam The Hague Airport";"2002 September";"    3670";"    6938";"     852";"     647";"     205";"     855";"     643";"     212";"   31840";"   20867";"   10973";"   31763";"   20623";"   11140";"   63603";"   62848";"   56805";"    6043";"     755";"     755";"     755";"       0";"       0";"       0";"       0";"       0";"       0";"       0";"       0";"       0";"       0";"       0";"       0";"       0";"       0";"       0"
"Rotterdam The Hague Airport";"2002 October";"    3017";"    3148";"     850";"     675";"     175";"     857";"     674";"     183";"   31432";"   22056";"    9376";"   27468";"   20575";"    6893";"   58900";"   58900";"   51935";"    6965";"       0";"       0";"       0";"       0";"       0";"       0";"       0";"       0";"       0";"       0";"       0";"       0";"       0";"       0";"       0";"       0";"       0";"       0"
"Rotterdam The Hague Airport";"2002 November";"    2739";"    2638";"     725";"     579";"     146";"     712";"     580";"     132";"   19577";"   16630";"    2947";"   18941";"   16045";"    2896";"   38518";"   38485";"   37265";"    1220";"      33";"       0";"       0";"       0";"       0";"       0";"       0";"       0";"       0";"       0";"       0";"      33";"      33";"       0";"       0";"       0";"       0";"       0"
"Rotterdam The Hague Airport";"2002 December";"    2002";"    1672";"     565";"     451";"     114";"     578";"     451";"     127";"   15388";"   13011";"    2377";"   16174";"   13616";"    2558";"   31562";"   31562";"   30577";"     985";"       0";"       0";"       0";"       0";"       0";"       0";"       0";"       0";"       0";"       0";"       0";"       0";"       0";"       0";"       0";"       0";"       0";"       0"
"Rotterdam The Hague Airport";"2003 January";"    1972";"    2030";"     498";"     383";"     115";"     512";"     386";"     126";"   15984";"   12975";"    3009";"   14967";"   11921";"    3046";"   30951";"   30951";"   30504";"     447";"       0";"       0";"       0";"       0";"       0";"       0";"       0";"       0";"       0";"       0";"       0";"       0";"       0";"       0";"       0";"       0";"       0";"       0"
"Rotterdam The Hague Airport";"2003 February";"    2291";"    2398";"     524";"     401";"     123";"     534";"     401";"     133";"   17144";"   13383";"    3761";"   17901";"   13837";"    4064";"   35045";"   35045";"   34068";"     977";"       0";"       0";"       0";"       0";"       0";"       0";"       0";"       0";"       0";"       0";"       0";"       0";"       0";"       0";"       0";"       0";"       0";"       0"
"Rotterdam The Hague Airport";"2003 March";"    2841";"    3062";"     579";"     425";"     154";"     584";"     427";"     157";"   19872";"   15198";"    4674";"   18627";"   14291";"    4336";"   38499";"   38499";"   35097";"    3402";"       0";"       0";"       0";"       0";"       0";"       0";"       0";"       0";"       0";"       0";"       0";"       0";"       0";"       0";"       0";"       0";"       0";"       0"
"Rotterdam The Hague Airport";"2003 April";"    2699";"    3282";"     575";"     442";"     133";"     579";"     443";"     136";"   19798";"   16036";"    3762";"   25236";"   18233";"    7003";"   45034";"   45034";"   43106";"    1928";"       0";"       0";"       0";"       0";"       0";"       0";"       0";"       0";"       0";"       0";"       0";"       0";"       0";"       0";"       0";"       0";"       0";"       0"
"Rotterdam The Hague Airport";"2003 May";"    3024";"    3726";"     726";"     503";"     223";"     721";"     502";"     219";"   33162";"   21057";"   12105";"   33746";"   20430";"   13316";"   66908";"   66908";"   58582";"    8326";"       0";"       0";"       0";"       0";"       0";"       0";"       0";"       0";"       0";"       0";"       0";"       0";"       0";"       0";"       0";"       0";"       0";"       0"
"Rotterdam The Hague Airport";"2003 June";"    3198";"    3856";"     676";"     474";"     202";"     679";"     465";"     214";"   32343";"   20818";"   11525";"   30927";"   19185";"   11742";"   63270";"   63270";"   55941";"    7329";"       0";"       0";"       0";"       0";"       0";"       0";"       0";"       0";"       0";"       0";"       0";"       0";"       0";"       0";"       0";"       0";"       0";"       0"
"Rotterdam The Hague Airport";"2003 July";"    2971";"    2988";"     721";"     518";"     203";"     708";"     511";"     197";"   31587";"   19678";"   11909";"   39982";"   23124";"   16858";"   71569";"   68236";"   55948";"   12288";"    3333";"    3333";"    3333";"       0";"       0";"       0";"       0";"       0";"       0";"       0";"       0";"       0";"       0";"       0";"       0";"       0";"       0";"       0"
"Rotterdam The Hague Airport";"2003 August";"    2721";"    3644";"     632";"     447";"     185";"     636";"     437";"     199";"   38428";"   22308";"   16120";"   26395";"   15771";"   10624";"   64823";"   61258";"   49429";"   11829";"    3565";"    3565";"    3565";"       0";"       0";"       0";"       0";"       0";"       0";"       0";"       0";"       0";"       0";"       0";"       0";"       0";"       0";"       0"
"Rotterdam The Hague Airport";"2003 September";"    3007";"    3854";"     727";"     488";"     239";"     732";"     483";"     249";"   31063";"   19487";"   11576";"   32385";"   19811";"   12574";"   63448";"   63216";"   55205";"    8011";"     232";"     232";"     232";"       0";"       0";"       0";"       0";"       0";"       0";"       0";"       0";"       0";"       0";"       0";"       0";"       0";"       0";"       0"
"Rotterdam The Hague Airport";"2003 October";"    2557";"    2766";"     610";"     421";"     189";"     613";"     421";"     192";"   32117";"   20408";"   11709";"   28336";"   19208";"    9128";"   60453";"   60453";"   51366";"    9087";"       0";"       0";"       0";"       0";"       0";"       0";"       0";"       0";"       0";"       0";"       0";"       0";"       0";"       0";"       0";"       0";"       0";"       0"
"Rotterdam The Hague Airport";"2003 November";"    2210";"    2216";"     519";"     393";"     126";"     517";"     383";"     134";"   21394";"   17540";"    3854";"   19365";"   15814";"    3551";"   40759";"   40759";"   38016";"    2743";"       0";"       0";"       0";"       0";"       0";"       0";"       0";"       0";"       0";"       0";"       0";"       0";"       0";"       0";"       0";"       0";"       0";"       0"
"Rotterdam The Hague Airport";"2003 December";"    1770";"    1836";"     431";"     307";"     124";"     425";"     311";"     114";"   17571";"   14110";"    3461";"   18493";"   14569";"    3924";"   36064";"   35825";"   33188";"    2637";"     239";"     239";"       0";"     239";"       0";"       0";"       0";"       0";"       0";"       0";"       0";"       0";"       0";"       0";"       0";"       0";"       0";"       0"
"Rotterdam The Hague Airport";"2004 January";"    1739";"    1808";"     458";"     354";"     104";"     487";"     351";"     136";"   18421";"   14565";"    3856";"   18090";"   13908";"    4182";"   36511";"   36511";"   35201";"    1310";"       0";"       0";"       0";"       0";"       0";"       0";"       0";"       0";"       0";"       0";"       0";"       0";"       0";"       0";"       0";"       0";"       0";"       0"
"Rotterdam The Hague Airport";"2004 February";"    2159";"    1740";"     539";"     380";"     159";"     551";"     383";"     168";"   19705";"   16065";"    3640";"   20695";"   16221";"    4474";"   40400";"   40356";"   38348";"    2008";"      44";"      44";"      44";"       0";"       0";"       0";"       0";"       0";"       0";"       0";"       0";"       0";"       0";"       0";"       0";"       0";"       0";"       0"
"Rotterdam The Hague Airport";"2004 March";"    2856";"    2886";"     704";"     546";"     158";"     731";"     550";"     181";"   31111";"   26543";"    4568";"   30985";"   25906";"    5079";"   62096";"   61946";"   55192";"    6754";"     150";"     150";"       0";"     150";"       0";"       0";"       0";"       0";"       0";"       0";"       0";"       0";"       0";"       0";"       0";"       0";"       0";"       0"
"Rotterdam The Hague Airport";"2004 April";"    3003";"    2858";"     760";"     584";"     176";"     764";"     588";"     176";"   45025";"   38235";"    6790";"   51983";"   40668";"   11315";"   97008";"   96988";"   79796";"   17192";"      20";"       0";"       0";"       0";"       0";"       0";"       0";"      20";"      20";"       0";"       0";"       0";"       0";"       0";"       0";"       0";"       0";"       0"
"Rotterdam The Hague Airport";"2004 May";"    3378";"    3136";"     826";"     577";"     249";"     832";"     578";"     254";"   57825";"   41725";"   16100";"   57117";"   40890";"   16227";"  114942";"  114942";"   93853";"   21089";"       0";"       0";"       0";"       0";"       0";"       0";"       0";"       0";"       0";"       0";"       0";"       0";"       0";"       0";"       0";"       0";"       0";"       0"
"Rotterdam The Hague Airport";"2004 June";"    3466";"    3076";"     950";"     666";"     284";"     957";"     667";"     290";"   55532";"   41035";"   14497";"   55678";"   40536";"   15142";"  111210";"  111210";"   93580";"   17630";"       0";"       0";"       0";"       0";"       0";"       0";"       0";"       0";"       0";"       0";"       0";"       0";"       0";"       0";"       0";"       0";"       0";"       0"
"Rotterdam The Hague Airport";"2004 July";"    3140";"    3178";"     860";"     660";"     200";"     870";"     662";"     208";"   57074";"   42731";"   14343";"   66978";"   47145";"   19833";"  124052";"  124052";"  100022";"   24030";"       0";"       0";"       0";"       0";"       0";"       0";"       0";"       0";"       0";"       0";"       0";"       0";"       0";"       0";"       0";"       0";"       0";"       0"
"Rotterdam The Hague Airport";"2004 August";"    2819";"    3126";"     826";"     632";"     194";"     835";"     634";"     201";"   65421";"   46902";"   18519";"   56330";"   42710";"   13620";"  121751";"  121748";"   99536";"   22212";"       3";"       0";"       0";"       0";"       0";"       0";"       0";"       3";"       3";"       0";"       0";"       0";"       0";"       0";"       0";"       0";"       0";"       0"
"Rotterdam The Hague Airport";"2004 September";"    3165";"    3038";"     883";"     656";"     227";"     879";"     659";"     220";"   55497";"   41210";"   14287";"   56452";"   40970";"   15482";"  111949";"  111872";"   94869";"   17003";"      77";"      50";"       0";"      50";"       0";"       0";"       0";"      27";"      27";"       0";"       0";"       0";"       0";"       0";"       0";"       0";"       0";"       0"
"Rotterdam The Hague Airport";"2004 October";"    3041";"    2572";"     879";"     653";"     226";"     876";"     654";"     222";"   60025";"   43982";"   16043";"   55897";"   42835";"   13062";"  115922";"  115872";"   92594";"   23278";"      50";"      50";"       0";"       0";"      50";"       0";"       0";"       0";"       0";"       0";"       0";"       0";"       0";"       0";"       0";"       0";"       0";"       0"
"Rotterdam The Hague Airport";"2004 November";"    2486";"    1658";"     748";"     613";"     135";"     751";"     619";"     132";"   41830";"   37266";"    4564";"   40646";"   36216";"    4430";"   82476";"   82075";"   71782";"   10293";"     401";"     401";"     250";"     151";"       0";"       0";"       0";"       0";"       0";"       0";"       0";"       0";"       0";"       0";"       0";"       0";"       0";"       0"
"Rotterdam The Hague Airport";"2004 December";"    2220";"    1420";"     659";"     542";"     117";"     654";"     540";"     114";"   38320";"   35610";"    2710";"   39877";"   37492";"    2385";"   78197";"   78157";"   70562";"    7595";"      40";"      40";"       0";"       0";"      40";"       0";"       0";"       0";"       0";"       0";"       0";"       0";"       0";"       0";"       0";"       0";"       0";"       0"
"Rotterdam The Hague Airport";"2005 January";"    2325";"    1592";"     657";"     551";"     106";"     685";"     552";"     133";"   37106";"   33871";"    3235";"   35346";"   32494";"    2852";"   72452";"   71805";"   64480";"    7325";"     647";"     647";"     647";"       0";"       0";"       0";"       0";"       0";"       0";"       0";"       0";"       0";"       0";"       0";"       0";"       0";"       0";"       0"
"Rotterdam The Hague Airport";"2005 February";"    2454";"    1750";"     711";"     575";"     136";"     733";"     583";"     150";"   36279";"   32347";"    3932";"   36875";"   33491";"    3384";"   73154";"   73108";"   64603";"    8505";"      46";"      45";"       0";"       0";"      45";"       0";"       0";"       1";"       1";"       0";"       0";"       0";"       0";"       0";"       0";"       0";"       0";"       0"
"Rotterdam The Hague Airport";"2005 March";"    2821";"    1846";"     818";"     672";"     146";"     815";"     664";"     151";"   44413";"   41215";"    3198";"   42161";"   38409";"    3752";"   86574";"   85041";"   75700";"    9341";"    1533";"     262";"       0";"       0";"       0";"       0";"     262";"     977";"     639";"       0";"     338";"     294";"     294";"       0";"       0";"       0";"       0";"       0"
"Rotterdam The Hague Airport";"2005 April";"    3113";"    3136";"     767";"     615";"     152";"     774";"     620";"     154";"   41853";"   37322";"    4531";"   44556";"   38398";"    6158";"   86409";"   86409";"   75558";"   10851";"       0";"       0";"       0";"       0";"       0";"       0";"       0";"       0";"       0";"       0";"       0";"       0";"       0";"       0";"       0";"       0";"       0";"       0"
"Rotterdam The Hague Airport";"2005 May";"    3144";"    3420";"     799";"     616";"     183";"     802";"     618";"     184";"   50507";"   40199";"   10308";"   51324";"   39538";"   11786";"  101831";"  101831";"   89201";"   12630";"       0";"       0";"       0";"       0";"       0";"       0";"       0";"       0";"       0";"       0";"       0";"       0";"       0";"       0";"       0";"       0";"       0";"       0"
"Rotterdam The Hague Airport";"2005 June";"    3507";"    3794";"     858";"     639";"     219";"     856";"     643";"     213";"   51567";"   39885";"   11682";"   51426";"   39472";"   11954";"  102993";"  102993";"   89356";"   13637";"       0";"       0";"       0";"       0";"       0";"       0";"       0";"       0";"       0";"       0";"       0";"       0";"       0";"       0";"       0";"       0";"       0";"       0"
"Rotterdam The Hague Airport";"2005 July";"    3047";"    3226";"     820";"     621";"     199";"     808";"     620";"     188";"   51894";"   39256";"   12638";"   58594";"   43307";"   15287";"  110488";"  110488";"   92167";"   18321";"       0";"       0";"       0";"       0";"       0";"       0";"       0";"       0";"       0";"       0";"       0";"       0";"       0";"       0";"       0";"       0";"       0";"       0"
"Rotterdam The Hague Airport";"2005 August";"    2801";"    3630";"     735";"     569";"     166";"     733";"     565";"     168";"   51945";"   38277";"   13668";"   44997";"   35196";"    9801";"   96942";"   96942";"   83680";"   13262";"       0";"       0";"       0";"       0";"       0";"       0";"       0";"       0";"       0";"       0";"       0";"       0";"       0";"       0";"       0";"       0";"       0";"       0"
"Rotterdam The Hague Airport";"2005 September";"    2742";"    3094";"     725";"     512";"     213";"     730";"     520";"     210";"   38212";"   27290";"   10922";"   40447";"   27881";"   12566";"   78659";"   78659";"   71551";"    7108";"       0";"       0";"       0";"       0";"       0";"       0";"       0";"       0";"       0";"       0";"       0";"       0";"       0";"       0";"       0";"       0";"       0";"       0"
"Rotterdam The Hague Airport";"2005 October";"    2540";"    2888";"     672";"     491";"     181";"     670";"     502";"     168";"   38870";"   27398";"   11472";"   35338";"   26323";"    9015";"   74208";"   74193";"   66162";"    8031";"      15";"      15";"       0";"      15";"       0";"       0";"       0";"       0";"       0";"       0";"       0";"       0";"       0";"       0";"       0";"       0";"       0";"       0"
"Rotterdam The Hague Airport";"2005 November";"    2406";"    2218";"     683";"     553";"     130";"     682";"     558";"     124";"   35376";"   32418";"    2958";"   32968";"   30460";"    2508";"   68344";"   67888";"   65816";"    2072";"     456";"       0";"       0";"       0";"       0";"       0";"       0";"     456";"       0";"       0";"     456";"       0";"       0";"       0";"       0";"       0";"       0";"       0"
"Rotterdam The Hague Airport";"2005 December";"    1930";"    1732";"     548";"     451";"      97";"     551";"     458";"      93";"   28234";"   26182";"    2052";"   30662";"   28831";"    1831";"   58896";"   58896";"   57896";"    1000";"       0";"       0";"       0";"       0";"       0";"       0";"       0";"       0";"       0";"       0";"       0";"       0";"       0";"       0";"       0";"       0";"       0";"       0"
"Rotterdam The Hague Airport";"2006 January";"    2366";"    2326";"     620";"     522";"      98";"     646";"     531";"     115";"   30362";"   28207";"    2155";"   28883";"   27120";"    1763";"   59245";"   59245";"   58099";"    1146";"       0";"       0";"       0";"       0";"       0";"       0";"       0";"       0";"       0";"       0";"       0";"       0";"       0";"       0";"       0";"       0";"       0";"       0"
"Rotterdam The Hague Airport";"2006 February";"    2382";"    1754";"     708";"     575";"     133";"     733";"     575";"     158";"   31889";"   28380";"    3509";"   34047";"   30784";"    3263";"   65936";"   65803";"   64350";"    1453";"     133";"       0";"       0";"       0";"       0";"       0";"       0";"       0";"       0";"       0";"       0";"     133";"     133";"       0";"       0";"       0";"       0";"       0"
"Rotterdam The Hague Airport";"2006 March";"    2795";"    2346";"     792";"     664";"     128";"     809";"     670";"     139";"   38863";"   36022";"    2841";"   38140";"   35558";"    2582";"   77003";"   76990";"   75205";"    1785";"      13";"       0";"       0";"       0";"       0";"       0";"       0";"       0";"       0";"       0";"       0";"      13";"       0";"       3";"      10";"       0";"       0";"       0"
"Rotterdam The Hague Airport";"2006 April";"    2733";"    3342";"     776";"     620";"     156";"     715";"     568";"     147";"   38465";"   35376";"    3089";"   42805";"   37305";"    5500";"   81270";"   81270";"   78462";"    2808";"       0";"       0";"       0";"       0";"       0";"       0";"       0";"       0";"       0";"       0";"       0";"       0";"       0";"       0";"       0";"       0";"       0";"       0"
"Rotterdam The Hague Airport";"2006 May";"    3175";"    3019";"     840";"     599";"     241";"     840";"     604";"     236";"   53889";"   40836";"   13053";"   55370";"   41440";"   13930";"  109259";"  109259";"  100080";"    9179";"       0";"       0";"       0";"       0";"       0";"       0";"       0";"       0";"       0";"       0";"       0";"       0";"       0";"       0";"       0";"       0";"       0";"       0"
"Rotterdam The Hague Airport";"2006 June";"    3585";"    3424";"     898";"     602";"     296";"     897";"     607";"     290";"   52676";"   39563";"   13113";"   51938";"   38629";"   13309";"  104614";"  104614";"   96505";"    8109";"       0";"       0";"       0";"       0";"       0";"       0";"       0";"       0";"       0";"       0";"       0";"       0";"       0";"       0";"       0";"       0";"       0";"       0"
"Rotterdam The Hague Airport";"2006 July";"    3123";"    3022";"     769";"     566";"     203";"     779";"     568";"     211";"   49937";"   37266";"   12671";"   58076";"   42399";"   15677";"  108013";"  108013";"   96426";"   11587";"       0";"       0";"       0";"       0";"       0";"       0";"       0";"       0";"       0";"       0";"       0";"       0";"       0";"       0";"       0";"       0";"       0";"       0"
"Rotterdam The Hague Airport";"2006 August";"    2448";"    2640";"     738";"     548";"     190";"     737";"     551";"     186";"   55117";"   41592";"   13525";"   46640";"   36369";"   10271";"  101757";"  101757";"   92434";"    9323";"       0";"       0";"       0";"       0";"       0";"       0";"       0";"       0";"       0";"       0";"       0";"       0";"       0";"       0";"       0";"       0";"       0";"       0"
"Rotterdam The Hague Airport";"2006 September";"    3226";"    3026";"     825";"     578";"     247";"     834";"     582";"     252";"   52519";"   39924";"   12595";"   54665";"   41269";"   13396";"  107184";"  107184";"   98396";"    8788";"       0";"       0";"       0";"       0";"       0";"       0";"       0";"       0";"       0";"       0";"       0";"       0";"       0";"       0";"       0";"       0";"       0";"       0"
"Rotterdam The Hague Airport";"2006 October";"    2928";"    2226";"     795";"     598";"     197";"     804";"     601";"     203";"   52509";"   41232";"   11277";"   46835";"   38526";"    8309";"   99344";"   99344";"   90776";"    8568";"       0";"       0";"       0";"       0";"       0";"       0";"       0";"       0";"       0";"       0";"       0";"       0";"       0";"       0";"       0";"       0";"       0";"       0"
"Rotterdam The Hague Airport";"2006 November";"    2630";"    2208";"     733";"     624";"     109";"     741";"     623";"     118";"   33957";"   32152";"    1805";"   31288";"   29636";"    1652";"   65245";"   65245";"   64518";"     727";"       0";"       0";"       0";"       0";"       0";"       0";"       0";"       0";"       0";"       0";"       0";"       0";"       0";"       0";"       0";"       0";"       0";"       0"
"Rotterdam The Hague Airport";"2006 December";"    2125";"    1406";"     636";"     531";"     105";"     611";"     509";"     102";"   27842";"   26455";"    1387";"   31259";"   29666";"    1593";"   59101";"   59101";"   57453";"    1648";"       0";"       0";"       0";"       0";"       0";"       0";"       0";"       0";"       0";"       0";"       0";"       0";"       0";"       0";"       0";"       0";"       0";"       0"
"Rotterdam The Hague Airport";"2007 January";"    2233";"    1686";"     692";"     592";"     100";"     704";"     595";"     109";"   32212";"   30897";"    1315";"   30347";"   28791";"    1556";"   62559";"   62549";"   59764";"    2785";"      10";"      10";"      10";"       0";"       0";"       0";"       0";"       0";"       0";"       0";"       0";"       0";"       0";"       0";"       0";"       0";"       0";"       0"
"Rotterdam The Hague Airport";"2007 February";"    2410";"    2064";"     719";"     607";"     112";"     736";"     615";"     121";"   31894";"   29862";"    2032";"   33760";"   31798";"    1962";"   65654";"   65626";"   62661";"    2965";"      28";"      28";"      28";"       0";"       0";"       0";"       0";"       0";"       0";"       0";"       0";"       0";"       0";"       0";"       0";"       0";"       0";"       0"
"Rotterdam The Hague Airport";"2007 March";"    2970";"    2496";"     793";"     654";"     139";"     801";"     658";"     143";"   40401";"   38702";"    1699";"   39681";"   37812";"    1869";"   80082";"   80082";"   76992";"    3090";"       0";"       0";"       0";"       0";"       0";"       0";"       0";"       0";"       0";"       0";"       0";"       0";"       0";"       0";"       0";"       0";"       0";"       0"
"Rotterdam The Hague Airport";"2007 April";"    3159";"    3400";"     750";"     597";"     153";"     748";"     606";"     142";"   38784";"   35900";"    2884";"   43266";"   38874";"    4392";"   82050";"   82050";"   80380";"    1670";"       0";"       0";"       0";"       0";"       0";"       0";"       0";"       0";"       0";"       0";"       0";"       0";"       0";"       0";"       0";"       0";"       0";"       0"
"Rotterdam The Hague Airport";"2007 May";"    3105";"    2908";"     854";"     624";"     230";"     854";"     627";"     227";"   55078";"   41950";"   13128";"   57157";"   42100";"   15057";"  112235";"  112235";"  103859";"    8376";"       0";"       0";"       0";"       0";"       0";"       0";"       0";"       0";"       0";"       0";"       0";"       0";"       0";"       0";"       0";"       0";"       0";"       0"
"Rotterdam The Hague Airport";"2007 June";"    3149";"    3192";"     833";"     604";"     229";"     846";"     604";"     242";"   52832";"   40032";"   12800";"   52068";"   39508";"   12560";"  104900";"  104900";"   98163";"    6737";"       0";"       0";"       0";"       0";"       0";"       0";"       0";"       0";"       0";"       0";"       0";"       0";"       0";"       0";"       0";"       0";"       0";"       0"
"Rotterdam The Hague Airport";"2007 July";"    2902";"    3014";"     824";"     610";"     214";"     817";"     613";"     204";"   50782";"   38525";"   12257";"   58454";"   43289";"   15165";"  109236";"  109236";"  100711";"    8525";"       0";"       0";"       0";"       0";"       0";"       0";"       0";"       0";"       0";"       0";"       0";"       0";"       0";"       0";"       0";"       0";"       0";"       0"
"Rotterdam The Hague Airport";"2007 August";"    2982";"    3184";"     777";"     573";"     204";"     784";"     577";"     207";"   56365";"   41467";"   14898";"   49470";"   36900";"   12570";"  105835";"  105835";"   97065";"    8770";"       0";"       0";"       0";"       0";"       0";"       0";"       0";"       0";"       0";"       0";"       0";"       0";"       0";"       0";"       0";"       0";"       0";"       0"
"Rotterdam The Hague Airport";"2007 September";"    3191";"    3222";"     840";"     605";"     235";"     845";"     609";"     236";"   52997";"   40248";"   12749";"   54551";"   40859";"   13692";"  107548";"  107548";"  100888";"    6660";"       0";"       0";"       0";"       0";"       0";"       0";"       0";"       0";"       0";"       0";"       0";"       0";"       0";"       0";"       0";"       0";"       0";"       0"
"Rotterdam The Hague Airport";"2007 October";"    3009";"    3066";"     829";"     634";"     195";"     838";"     633";"     205";"   54721";"   42889";"   11832";"   47698";"   39241";"    8457";"  102419";"  102419";"   95571";"    6848";"       0";"       0";"       0";"       0";"       0";"       0";"       0";"       0";"       0";"       0";"       0";"       0";"       0";"       0";"       0";"       0";"       0";"       0"
"Rotterdam The Hague Airport";"2007 November";"    2476";"    2078";"     719";"     618";"     101";"     739";"     623";"     116";"   34219";"   32739";"    1480";"   32277";"   31055";"    1222";"   66496";"   66402";"   66337";"      65";"      94";"      94";"      94";"       0";"       0";"       0";"       0";"       0";"       0";"       0";"       0";"       0";"       0";"       0";"       0";"       0";"       0";"       0"
"Rotterdam The Hague Airport";"2007 December";"    2015";"    1618";"     603";"     509";"      94";"     610";"     510";"     100";"   29177";"   27782";"    1395";"   31853";"   30596";"    1257";"   61030";"   61030";"   59956";"    1074";"       0";"       0";"       0";"       0";"       0";"       0";"       0";"       0";"       0";"       0";"       0";"       0";"       0";"       0";"       0";"       0";"       0";"       0"
"Rotterdam The Hague Airport";"2008 January";"    2314";"    1538";"     688";"     599";"      89";"     695";"     605";"      90";"   34094";"   32726";"    1368";"   33225";"   31725";"    1500";"   67319";"   67319";"   64616";"    2703";"       0";"       0";"       0";"       0";"       0";"       0";"       0";"       0";"       0";"       0";"       0";"       0";"       0";"       0";"       0";"       0";"       0";"       0"
"Rotterdam The Hague Airport";"2008 February";"    2672";"    2086";"     709";"     573";"     136";"     718";"     581";"     137";"   32648";"   30635";"    2013";"   34531";"   32619";"    1912";"   67179";"   67179";"   64567";"    2612";"       0";"       0";"       0";"       0";"       0";"       0";"       0";"       0";"       0";"       0";"       0";"       0";"       0";"       0";"       0";"       0";"       0";"       0"
"Rotterdam The Hague Airport";"2008 March";"    2578";"    1836";"     778";"     643";"     135";"     796";"     646";"     150";"   42668";"   40186";"    2482";"   40075";"   37705";"    2370";"   82743";"   82643";"   78096";"    4547";"     100";"     100";"     100";"       0";"       0";"       0";"       0";"       0";"       0";"       0";"       0";"       0";"       0";"       0";"       0";"       0";"       0";"       0"
"Rotterdam The Hague Airport";"2008 April";"    3079";"    3230";"     801";"     630";"     171";"     794";"     634";"     160";"   35584";"   32034";"    3550";"   43330";"   36656";"    6674";"   78914";"   78825";"   76299";"    2526";"      89";"       0";"       0";"       0";"       0";"       0";"       0";"      89";"      89";"       0";"       0";"       0";"       0";"       0";"       0";"       0";"       0";"       0"
"Rotterdam The Hague Airport";"2008 May";"    2976";"    2696";"     749";"     544";"     205";"     748";"     544";"     204";"   47951";"   35158";"   12793";"   47474";"   34304";"   13170";"   95425";"   95425";"   86349";"    9076";"       0";"       0";"       0";"       0";"       0";"       0";"       0";"       0";"       0";"       0";"       0";"       0";"       0";"       0";"       0";"       0";"       0";"       0"
"Rotterdam The Hague Airport";"2008 June";"    3194";"    2548";"     853";"     598";"     255";"     855";"     603";"     252";"   50299";"   35598";"   14701";"   50582";"   36217";"   14365";"  100881";"  100881";"   92193";"    8688";"       0";"       0";"       0";"       0";"       0";"       0";"       0";"       0";"       0";"       0";"       0";"       0";"       0";"       0";"       0";"       0";"       0";"       0"
"Rotterdam The Hague Airport";"2008 July";"    3020";"    2808";"     800";"     570";"     230";"     795";"     577";"     218";"   49388";"   35891";"   13497";"   54915";"   40095";"   14820";"  104303";"  104303";"   93611";"   10692";"       0";"       0";"       0";"       0";"       0";"       0";"       0";"       0";"       0";"       0";"       0";"       0";"       0";"       0";"       0";"       0";"       0";"       0"
"Rotterdam The Hague Airport";"2008 August";"    2587";"    2734";"     716";"     519";"     197";"     722";"     519";"     203";"   53654";"   36621";"   17033";"   45141";"   31075";"   14066";"   98795";"   98795";"   88265";"   10530";"       0";"       0";"       0";"       0";"       0";"       0";"       0";"       0";"       0";"       0";"       0";"       0";"       0";"       0";"       0";"       0";"       0";"       0"
"Rotterdam The Hague Airport";"2008 September";"    3118";"    2812";"     810";"     586";"     224";"     799";"     592";"     207";"   48454";"   34474";"   13980";"   50114";"   35499";"   14615";"   98568";"   98568";"   89419";"    9149";"       0";"       0";"       0";"       0";"       0";"       0";"       0";"       0";"       0";"       0";"       0";"       0";"       0";"       0";"       0";"       0";"       0";"       0"
"Rotterdam The Hague Airport";"2008 October";"    2670";"    2278";"     750";"     549";"     201";"     753";"     556";"     197";"   46767";"   34969";"   11798";"   40556";"   32119";"    8437";"   87323";"   87323";"   80011";"    7312";"       0";"       0";"       0";"       0";"       0";"       0";"       0";"       0";"       0";"       0";"       0";"       0";"       0";"       0";"       0";"       0";"       0";"       0"
"Rotterdam The Hague Airport";"2008 November";"    1901";"    1474";"     533";"     434";"      99";"     530";"     435";"      95";"   26478";"   24692";"    1786";"   23989";"   22143";"    1846";"   50467";"   50467";"   50388";"      79";"       0";"       0";"       0";"       0";"       0";"       0";"       0";"       0";"       0";"       0";"       0";"       0";"       0";"       0";"       0";"       0";"       0";"       0"
"Rotterdam The Hague Airport";"2008 December";"    1843";"    1652";"     527";"     440";"      87";"     528";"     442";"      86";"   25655";"   23960";"    1695";"   29217";"   28002";"    1215";"   54872";"   54872";"   53286";"    1586";"       0";"       0";"       0";"       0";"       0";"       0";"       0";"       0";"       0";"       0";"       0";"       0";"       0";"       0";"       0";"       0";"       0";"       0"
"Rotterdam The Hague Airport";"2009 January";"    2063";"    1448";"     625";"     550";"      75";"     620";"     539";"      81";"   31902";"   30703";"    1199";"   30435";"   29043";"    1392";"   62337";"   62337";"   59560";"    2777";"       0";"       0";"       0";"       0";"       0";"       0";"       0";"       0";"       0";"       0";"       0";"       0";"       0";"       0";"       0";"       0";"       0";"       0"
"Rotterdam The Hague Airport";"2009 February";"    2052";"    1246";"     610";"     534";"      76";"     611";"     523";"      88";"   32447";"   29926";"    2521";"   32795";"   30588";"    2207";"   65242";"   65241";"   62287";"    2954";"       1";"       0";"       0";"       0";"       0";"       0";"       0";"       1";"       1";"       0";"       0";"       0";"       0";"       0";"       0";"       0";"       0";"       0"
"Rotterdam The Hague Airport";"2009 March";"    2515";"    1856";"     624";"     549";"      75";"     640";"     551";"      89";"   37020";"   35349";"    1671";"   34663";"   32997";"    1666";"   71683";"   71683";"   68543";"    3140";"       0";"       0";"       0";"       0";"       0";"       0";"       0";"       0";"       0";"       0";"       0";"       0";"       0";"       0";"       0";"       0";"       0";"       0"
"Rotterdam The Hague Airport";"2009 April";"    2565";"    2228";"     614";"     507";"     107";"     615";"     508";"     107";"   30559";"   27467";"    3092";"   36317";"   30753";"    5564";"   66876";"   66676";"   64765";"    1911";"     200";"     200";"     200";"       0";"       0";"       0";"       0";"       0";"       0";"       0";"       0";"       0";"       0";"       0";"       0";"       0";"       0";"       0"
"Rotterdam The Hague Airport";"2009 May";"    2840";"    2868";"     711";"     535";"     176";"     717";"     539";"     178";"   45621";"   33192";"   12429";"   45820";"   32005";"   13815";"   91441";"   91232";"   83829";"    7403";"     209";"       0";"       0";"       0";"       0";"       0";"       0";"     209";"       0";"     209";"       0";"       0";"       0";"       0";"       0";"       0";"       0";"       0"
"Rotterdam The Hague Airport";"2009 June";"    2888";"    2436";"     730";"     535";"     195";"     730";"     539";"     191";"   45943";"   32201";"   13742";"   44905";"   31609";"   13296";"   90848";"   90848";"   82900";"    7948";"       0";"       0";"       0";"       0";"       0";"       0";"       0";"       0";"       0";"       0";"       0";"       0";"       0";"       0";"       0";"       0";"       0";"       0"
"Rotterdam The Hague Airport";"2009 July";"    2736";"    1944";"     715";"     521";"     194";"     711";"     524";"     187";"   44457";"   32111";"   12346";"   52444";"   36730";"   15714";"   96901";"   96901";"   88970";"    7931";"       0";"       0";"       0";"       0";"       0";"       0";"       0";"       0";"       0";"       0";"       0";"       0";"       0";"       0";"       0";"       0";"       0";"       0"
"Rotterdam The Hague Airport";"2009 August";"    2637";"    2460";"     619";"     450";"     169";"     628";"     451";"     177";"   52138";"   35227";"   16911";"   44390";"   30089";"   14301";"   96528";"   96528";"   87108";"    9420";"       0";"       0";"       0";"       0";"       0";"       0";"       0";"       0";"       0";"       0";"       0";"       0";"       0";"       0";"       0";"       0";"       0";"       0"
"Rotterdam The Hague Airport";"2009 September";"    2768";"    2472";"     677";"     509";"     168";"     681";"     510";"     171";"   46108";"   32547";"   13561";"   46643";"   33076";"   13567";"   92751";"   92751";"   84986";"    7765";"       0";"       0";"       0";"       0";"       0";"       0";"       0";"       0";"       0";"       0";"       0";"       0";"       0";"       0";"       0";"       0";"       0";"       0"
"Rotterdam The Hague Airport";"2009 October";"    2502";"    2126";"     689";"     530";"     159";"     686";"     529";"     157";"   45817";"   34104";"   11713";"   39781";"   31464";"    8317";"   85598";"   85515";"   78481";"    7034";"      83";"      83";"      83";"       0";"       0";"       0";"       0";"       0";"       0";"       0";"       0";"       0";"       0";"       0";"       0";"       0";"       0";"       0"
"Rotterdam The Hague Airport";"2009 November";"    1925";"    1362";"     546";"     445";"     101";"     546";"     451";"      95";"   25288";"   23339";"    1949";"   23030";"   21261";"    1769";"   48318";"   48236";"   47117";"    1119";"      82";"      82";"      82";"       0";"       0";"       0";"       0";"       0";"       0";"       0";"       0";"       0";"       0";"       0";"       0";"       0";"       0";"       0"
"Rotterdam The Hague Airport";"2009 December";"    1811";"    1152";"     531";"     436";"      95";"     521";"     441";"      80";"   24627";"   23490";"    1137";"   28690";"   27369";"    1321";"   53317";"   53317";"   51563";"    1754";"       0";"       0";"       0";"       0";"       0";"       0";"       0";"       0";"       0";"       0";"       0";"       0";"       0";"       0";"       0";"       0";"       0";"       0"
"Rotterdam The Hague Airport";"2010 January";"    1900";"    1318";"     580";"     501";"      79";"     589";"     497";"      92";"   30537";"   29082";"    1455";"   29047";"   27701";"    1346";"   59584";"   59005";"   55853";"    3152";"     579";"       0";"       0";"       0";"       0";"       0";"       0";"       0";"       0";"       0";"       0";"     579";"       0";"     318";"     261";"       0";"       0";"       0"
"Rotterdam The Hague Airport";"2010 February";"    1899";"    1338";"     551";"     468";"      83";"     553";"     470";"      83";"   29903";"   27751";"    2152";"   32307";"   30142";"    2165";"   62210";"   62210";"   59312";"    2898";"       0";"       0";"       0";"       0";"       0";"       0";"       0";"       0";"       0";"       0";"       0";"       0";"       0";"       0";"       0";"       0";"       0";"       0"
"Rotterdam The Hague Airport";"2010 March";"    2841";"    2468";"     623";"     532";"      91";"     623";"     536";"      87";"   37539";"   35863";"    1676";"   35282";"   33630";"    1652";"   72821";"   72821";"   68872";"    3949";"       0";"       0";"       0";"       0";"       0";"       0";"       0";"       0";"       0";"       0";"       0";"       0";"       0";"       0";"       0";"       0";"       0";"       0"
"Rotterdam The Hague Airport";"2010 April";"    2310";"    2454";"     491";"     394";"      97";"     487";"     397";"      90";"   23547";"   21122";"    2425";"   28212";"   23751";"    4461";"   51759";"   51759";"   49101";"    2658";"       0";"       0";"       0";"       0";"       0";"       0";"       0";"       0";"       0";"       0";"       0";"       0";"       0";"       0";"       0";"       0";"       0";"       0"
"Rotterdam The Hague Airport";"2010 May";"    2772";"    2406";"     688";"     478";"     210";"     685";"     482";"     203";"   46976";"   32582";"   14394";"   49836";"   32721";"   17115";"   96812";"   96812";"   85968";"   10844";"       0";"       0";"       0";"       0";"       0";"       0";"       0";"       0";"       0";"       0";"       0";"       0";"       0";"       0";"       0";"       0";"       0";"       0"
"Rotterdam The Hague Airport";"2010 June";"    2977";"    2612";"     719";"     487";"     232";"     718";"     490";"     228";"   47096";"   31610";"   15486";"   43930";"   30643";"   13287";"   91026";"   91026";"   81153";"    9873";"       0";"       0";"       0";"       0";"       0";"       0";"       0";"       0";"       0";"       0";"       0";"       0";"       0";"       0";"       0";"       0";"       0";"       0"
"Rotterdam The Hague Airport";"2010 July";"    2807";"    2158";"     733";"     480";"     253";"     729";"     484";"     245";"   46856";"   31584";"   15272";"   55893";"   36731";"   19162";"  102749";"  102049";"   87688";"   14361";"     700";"     700";"       0";"     401";"     299";"       0";"       0";"       0";"       0";"       0";"       0";"       0";"       0";"       0";"       0";"       0";"       0";"       0"
"Rotterdam The Hague Airport";"2010 August";"    2423";"    2176";"     675";"     451";"     224";"     670";"     449";"     221";"   56300";"   36821";"   19479";"   47061";"   31804";"   15257";"  103361";"  102519";"   89362";"   13157";"     842";"     842";"       4";"     508";"     330";"       0";"       0";"       0";"       0";"       0";"       0";"       0";"       0";"       0";"       0";"       0";"       0";"       0"
"Rotterdam The Hague Airport";"2010 September";"    2668";"    2464";"     711";"     489";"     222";"     707";"     494";"     213";"   49028";"   33695";"   15333";"   51071";"   35124";"   15947";"  100099";"   99696";"   89862";"    9834";"     403";"     403";"     225";"       0";"     178";"       0";"       0";"       0";"       0";"       0";"       0";"       0";"       0";"       0";"       0";"       0";"       0";"       0"
"Rotterdam The Hague Airport";"2010 October";"    2583";"    2314";"     657";"     481";"     176";"     657";"     487";"     170";"   48536";"   35562";"   12974";"   42105";"   32704";"    9401";"   90641";"   90403";"   79094";"   11309";"     238";"     238";"       0";"       0";"     238";"       0";"       0";"       0";"       0";"       0";"       0";"       0";"       0";"       0";"       0";"       0";"       0";"       0"
"Rotterdam The Hague Airport";"2010 November";"    1798";"    1496";"     461";"     361";"     100";"     461";"     359";"     102";"   24728";"   22477";"    2251";"   21472";"   19251";"    2221";"   46200";"   46148";"   45003";"    1145";"      52";"      52";"       0";"       0";"      52";"       0";"       0";"       0";"       0";"       0";"       0";"       0";"       0";"       0";"       0";"       0";"       0";"       0"
"Rotterdam The Hague Airport";"2010 December";"    1527";"     928";"     445";"     337";"     108";"     430";"     343";"      87";"   20794";"   19533";"    1261";"   24513";"   23127";"    1386";"   45307";"   44859";"   42790";"    2069";"     448";"     448";"     163";"       0";"       0";"     285";"       0";"       0";"       0";"       0";"       0";"       0";"       0";"       0";"       0";"       0";"       0";"       0"
"Rotterdam The Hague Airport";"2011 January";"    2071";"    1598";"     507";"     437";"      70";"     525";"     441";"      84";"   28274";"   27242";"    1032";"   27112";"   25938";"    1174";"   55386";"   55386";"   52809";"    2577";"       0";"       0";"       0";"       0";"       0";"       0";"       0";"       0";"       0";"       0";"       0";"       0";"       0";"       0";"       0";"       0";"       0";"       0"
"Rotterdam The Hague Airport";"2011 February";"    2116";"    1312";"     546";"     439";"     107";"     549";"     443";"     106";"   28896";"   26716";"    2180";"   31091";"   28832";"    2259";"   59987";"   59987";"   57542";"    2445";"       0";"       0";"       0";"       0";"       0";"       0";"       0";"       0";"       0";"       0";"       0";"       0";"       0";"       0";"       0";"       0";"       0";"       0"
"Rotterdam The Hague Airport";"2011 March";"    2706";"    2684";"     588";"     491";"      97";"     589";"     494";"      95";"   38266";"   36103";"    2163";"   35892";"   33967";"    1925";"   74158";"   74158";"   69683";"    4475";"       0";"       0";"       0";"       0";"       0";"       0";"       0";"       0";"       0";"       0";"       0";"       0";"       0";"       0";"       0";"       0";"       0";"       0"
"Rotterdam The Hague Airport";"2011 April";"    2596";"    2542";"     559";"     423";"     136";"     552";"     426";"     126";"   32679";"   29189";"    3490";"   38303";"   32281";"    6022";"   70982";"   70982";"   66335";"    4647";"       0";"       0";"       0";"       0";"       0";"       0";"       0";"       0";"       0";"       0";"       0";"       0";"       0";"       0";"       0";"       0";"       0";"       0"
"Rotterdam The Hague Airport";"2011 May";"    2895";"    2496";"     754";"     554";"     200";"     756";"     554";"     202";"   55129";"   43206";"   11923";"   57069";"   43778";"   13291";"  112198";"  112198";"  100465";"   11733";"       0";"       0";"       0";"       0";"       0";"       0";"       0";"       0";"       0";"       0";"       0";"       0";"       0";"       0";"       0";"       0";"       0";"       0"
"Rotterdam The Hague Airport";"2011 June";"    2705";"    2184";"     722";"     506";"     216";"     730";"     508";"     222";"   57180";"   44233";"   12947";"   56123";"   43526";"   12597";"  113303";"  112957";"  103439";"    9518";"     346";"     346";"     346";"       0";"       0";"       0";"       0";"       0";"       0";"       0";"       0";"       0";"       0";"       0";"       0";"       0";"       0";"       0"
"Rotterdam The Hague Airport";"2011 July";"    2650";"    2318";"     701";"     480";"     221";"     711";"     481";"     230";"   59745";"   45501";"   14244";"   67070";"   50904";"   16166";"  126815";"  126140";"  114106";"   12034";"     675";"     675";"     675";"       0";"       0";"       0";"       0";"       0";"       0";"       0";"       0";"       0";"       0";"       0";"       0";"       0";"       0";"       0"
"Rotterdam The Hague Airport";"2011 August";"    2541";"    2584";"     677";"     484";"     193";"     683";"     482";"     201";"   64557";"   50829";"   13728";"   55817";"   44672";"   11145";"  120374";"  120017";"  109719";"   10298";"     357";"     357";"     357";"       0";"       0";"       0";"       0";"       0";"       0";"       0";"       0";"       0";"       0";"       0";"       0";"       0";"       0";"       0"
"Rotterdam The Hague Airport";"2011 September";"    2789";"    2194";"     754";"     508";"     246";"     739";"     511";"     228";"   58817";"   45762";"   13055";"   58055";"   44791";"   13264";"  116872";"  116872";"  105353";"   11519";"       0";"       0";"       0";"       0";"       0";"       0";"       0";"       0";"       0";"       0";"       0";"       0";"       0";"       0";"       0";"       0";"       0";"       0"
"Rotterdam The Hague Airport";"2011 October";"    2609";"    2064";"     691";"     510";"     181";"     700";"     513";"     187";"   56889";"   46137";"   10752";"   49534";"   41889";"    7645";"  106423";"  106423";"   96087";"   10336";"       0";"       0";"       0";"       0";"       0";"       0";"       0";"       0";"       0";"       0";"       0";"       0";"       0";"       0";"       0";"       0";"       0";"       0"
"Rotterdam The Hague Airport";"2011 November";"    1750";"    1466";"     460";"     356";"     104";"     461";"     365";"      96";"   28614";"   26345";"    2269";"   26629";"   24643";"    1986";"   55243";"   55243";"   54145";"    1098";"       0";"       0";"       0";"       0";"       0";"       0";"       0";"       0";"       0";"       0";"       0";"       0";"       0";"       0";"       0";"       0";"       0";"       0"
"Rotterdam The Hague Airport";"2011 December";"    1689";"    1340";"     497";"     426";"      71";"     497";"     425";"      72";"   29614";"   27835";"    1779";"   33847";"   32468";"    1379";"   63461";"   63199";"   62023";"    1176";"     262";"     262";"     262";"       0";"       0";"       0";"       0";"       0";"       0";"       0";"       0";"       0";"       0";"       0";"       0";"       0";"       0";"       0"
"Rotterdam The Hague Airport";"2012 January";"    2027";"    1246";"     573";"     494";"      79";"     580";"     494";"      86";"   38593";"   37102";"    1491";"   36473";"   34648";"    1825";"   75066";"   75066";"   72628";"    2438";"       0";"       0";"       0";"       0";"       0";"       0";"       0";"       0";"       0";"       0";"       0";"       0";"       0";"       0";"       0";"       0";"       0";"       0"
"Rotterdam The Hague Airport";"2012 February";"    2083";"    1328";"     577";"     485";"      92";"     582";"     485";"      97";"   37891";"   35328";"    2563";"   40241";"   37922";"    2319";"   78132";"   77992";"   75711";"    2281";"     140";"     140";"     140";"       0";"       0";"       0";"       0";"       0";"       0";"       0";"       0";"       0";"       0";"       0";"       0";"       0";"       0";"       0"
"Rotterdam The Hague Airport";"2012 March";"    2518";"    1996";"     619";"     517";"     102";"     626";"     523";"     103";"   47043";"   45332";"    1711";"   44375";"   42670";"    1705";"   91418";"   91418";"   88258";"    3160";"       0";"       0";"       0";"       0";"       0";"       0";"       0";"       0";"       0";"       0";"       0";"       0";"       0";"       0";"       0";"       0";"       0";"       0"
"Rotterdam The Hague Airport";"2012 April";"    2139";"    1780";"     555";"     424";"     131";"     561";"     425";"     136";"   38950";"   35252";"    3698";"   42683";"   36801";"    5882";"   81633";"   81633";"   77984";"    3649";"       0";"       0";"       0";"       0";"       0";"       0";"       0";"       0";"       0";"       0";"       0";"       0";"       0";"       0";"       0";"       0";"       0";"       0"
"Rotterdam The Hague Airport";"2012 May";"    2770";"    2188";"     741";"     531";"     210";"     744";"     539";"     205";"   59897";"   47317";"   12580";"   62020";"   48558";"   13462";"  121917";"  121917";"  110040";"   11877";"       0";"       0";"       0";"       0";"       0";"       0";"       0";"       0";"       0";"       0";"       0";"       0";"       0";"       0";"       0";"       0";"       0";"       0"
"Rotterdam The Hague Airport";"2012 June";"    2552";"    1894";"     720";"     514";"     206";"     724";"     519";"     205";"   59390";"   46964";"   12426";"   58879";"   46749";"   12130";"  118269";"  117134";"  105276";"   11858";"    1135";"    1135";"    1135";"       0";"       0";"       0";"       0";"       0";"       0";"       0";"       0";"       0";"       0";"       0";"       0";"       0";"       0";"       0"
"Rotterdam The Hague Airport";"2012 July";"    2714";"    1786";"     735";"     502";"     233";"     730";"     503";"     227";"   61128";"   47444";"   13684";"   69818";"   53679";"   16139";"  130946";"  129979";"  115874";"   14105";"     967";"     967";"     967";"       0";"       0";"       0";"       0";"       0";"       0";"       0";"       0";"       0";"       0";"       0";"       0";"       0";"       0";"       0"
"Rotterdam The Hague Airport";"2012 August";"    2617";"    1912";"     736";"     521";"     215";"     699";"     481";"     218";"   70158";"   53630";"   16528";"   60808";"   47346";"   13462";"  130966";"  130365";"  117322";"   13043";"     601";"     601";"     601";"       0";"       0";"       0";"       0";"       0";"       0";"       0";"       0";"       0";"       0";"       0";"       0";"       0";"       0";"       0"
"Rotterdam The Hague Airport";"2012 September";"    2572";"    2110";"     701";"     505";"     196";"     696";"     505";"     191";"   62143";"   49477";"   12666";"   61512";"   48811";"   12701";"  123655";"  123171";"  111367";"   11804";"     484";"     484";"     484";"       0";"       0";"       0";"       0";"       0";"       0";"       0";"       0";"       0";"       0";"       0";"       0";"       0";"       0";"       0"
"Rotterdam The Hague Airport";"2012 October";"    2416";"    1854";"     725";"     563";"     162";"     733";"     568";"     165";"   62116";"   51383";"   10733";"   55724";"   47211";"    8513";"  117840";"  117833";"  105710";"   12123";"       7";"       7";"       7";"       0";"       0";"       0";"       0";"       0";"       0";"       0";"       0";"       0";"       0";"       0";"       0";"       0";"       0";"       0"
"Rotterdam The Hague Airport";"2012 November";"    1622";"    1410";"     460";"     384";"      76";"     463";"     382";"      81";"   28368";"   26825";"    1543";"   25753";"   24074";"    1679";"   54121";"   54121";"   53097";"    1024";"       0";"       0";"       0";"       0";"       0";"       0";"       0";"       0";"       0";"       0";"       0";"       0";"       0";"       0";"       0";"       0";"       0";"       0"
"Rotterdam The Hague Airport";"2012 December";"    1545";"    1050";"     483";"     414";"      69";"     482";"     415";"      67";"   28657";"   27219";"    1438";"   33919";"   32559";"    1360";"   62576";"   62576";"   61283";"    1293";"       0";"       0";"       0";"       0";"       0";"       0";"       0";"       0";"       0";"       0";"       0";"       0";"       0";"       0";"       0";"       0";"       0";"       0"
"Rotterdam The Hague Airport";"2013 January";"    1898";"    1124";"     660";"     584";"      76";"     665";"     584";"      81";"   43113";"   41998";"    1115";"   41121";"   39853";"    1268";"   84234";"   84234";"   81527";"    2707";"       0";"       0";"       0";"       0";"       0";"       0";"       0";"       0";"       0";"       0";"       0";"       0";"       0";"       0";"       0";"       0";"       0";"       0"
"Rotterdam The Hague Airport";"2013 February";"    2054";"    1394";"     638";"     554";"      84";"     635";"     559";"      76";"   43511";"   41515";"    1996";"   46927";"   45027";"    1900";"   90438";"   90438";"   87606";"    2832";"       0";"       0";"       0";"       0";"       0";"       0";"       0";"       0";"       0";"       0";"       0";"       0";"       0";"       0";"       0";"       0";"       0";"       0"
"Rotterdam The Hague Airport";"2013 March";"    2412";"    1888";"     728";"     647";"      81";"     737";"     644";"      93";"   56437";"   54840";"    1597";"   54049";"   52465";"    1584";"  110486";"  110486";"  107102";"    3384";"       0";"       0";"       0";"       0";"       0";"       0";"       0";"       0";"       0";"       0";"       0";"       0";"       0";"       0";"       0";"       0";"       0";"       0"
"Rotterdam The Hague Airport";"2013 April";"    2679";"    2146";"     750";"     614";"     136";"     752";"     613";"     139";"   52501";"   48376";"    4125";"   58361";"   52375";"    5986";"  110862";"  110862";"  103825";"    7037";"       0";"       0";"       0";"       0";"       0";"       0";"       0";"       0";"       0";"       0";"       0";"       0";"       0";"       0";"       0";"       0";"       0";"       0"
"Rotterdam The Hague Airport";"2013 May";"    2812";"    1886";"     919";"     727";"     192";"     936";"     732";"     204";"   79382";"   68448";"   10934";"   81022";"   69754";"   11268";"  160404";"  160404";"  145199";"   15205";"       0";"       0";"       0";"       0";"       0";"       0";"       0";"       0";"       0";"       0";"       0";"       0";"       0";"       0";"       0";"       0";"       0";"       0"
"Rotterdam The Hague Airport";"2013 June";"    2846";"    1898";"     894";"     710";"     184";"     902";"     713";"     189";"   77440";"   66612";"   10828";"   78006";"   67844";"   10162";"  155446";"  154921";"  140221";"   14700";"     525";"     525";"     525";"       0";"       0";"       0";"       0";"       0";"       0";"       0";"       0";"       0";"       0";"       0";"       0";"       0";"       0";"       0"
"Rotterdam The Hague Airport";"2013 July";"    2948";"    2360";"     910";"     711";"     199";"     907";"     711";"     196";"   72390";"   63413";"    8977";"   82427";"   70355";"   12072";"  154817";"  152036";"  136877";"   15159";"    2781";"    2781";"    2781";"       0";"       0";"       0";"       0";"       0";"       0";"       0";"       0";"       0";"       0";"       0";"       0";"       0";"       0";"       0"
"Rotterdam The Hague Airport";"2013 August";"    2724";"    2078";"     831";"     630";"     201";"     852";"     630";"     222";"   81355";"   67286";"   14069";"   73915";"   60784";"   13131";"  155270";"  150615";"  131913";"   18702";"    4655";"    4655";"    4655";"       0";"       0";"       0";"       0";"       0";"       0";"       0";"       0";"       0";"       0";"       0";"       0";"       0";"       0";"       0"
"Rotterdam The Hague Airport";"2013 September";"    2776";"    1676";"     923";"     721";"     202";"     931";"     720";"     211";"   82165";"   70564";"   11601";"   78990";"   67532";"   11458";"  161155";"  159247";"  143687";"   15560";"    1908";"    1908";"    1908";"       0";"       0";"       0";"       0";"       0";"       0";"       0";"       0";"       0";"       0";"       0";"       0";"       0";"       0";"       0"
"Rotterdam The Hague Airport";"2013 October";"    2566";"    1690";"     835";"     669";"     166";"     844";"     670";"     174";"   72111";"   62423";"    9688";"   64819";"   57527";"    7292";"  136930";"  135335";"  123325";"   12010";"    1595";"    1595";"    1595";"       0";"       0";"       0";"       0";"       0";"       0";"       0";"       0";"       0";"       0";"       0";"       0";"       0";"       0";"       0"
"Rotterdam The Hague Airport";"2013 November";"    1977";"    1644";"     625";"     530";"      95";"     630";"     530";"     100";"   42700";"   40953";"    1747";"   39245";"   37520";"    1725";"   81945";"   79326";"   75991";"    3335";"    2619";"    2617";"    2430";"     187";"       0";"       0";"       0";"       2";"       0";"       2";"       0";"       0";"       0";"       0";"       0";"       0";"       0";"       0"
"Rotterdam The Hague Airport";"2013 December";"    1805";"    1386";"     577";"     508";"      69";"     578";"     509";"      69";"   40472";"   39140";"    1332";"   46113";"   44806";"    1307";"   86585";"   84825";"   80779";"    4046";"    1760";"    1760";"    1532";"     228";"       0";"       0";"       0";"       0";"       0";"       0";"       0";"       0";"       0";"       0";"       0";"       0";"       0";"       0"
"Rotterdam The Hague Airport";"2014 January";"    1991";"    1274";"     668";"     599";"      69";"     677";"     600";"      77";"   48725";"   47629";"    1096";"   45552";"   44255";"    1297";"   94277";"   92784";"   87089";"    5695";"    1493";"    1422";"    1422";"       0";"       0";"       0";"       0";"       0";"       0";"       0";"       0";"      71";"      71";"       0";"       0";"       0";"       0";"       0"
"Rotterdam The Hague Airport";"2014 February";"    2064";"    1474";"     675";"     587";"      88";"     683";"     591";"      92";"   51772";"   49651";"    2121";"   54756";"   52798";"    1958";"  106528";"  104768";"   97748";"    7020";"    1760";"    1760";"    1760";"       0";"       0";"       0";"       0";"       0";"       0";"       0";"       0";"       0";"       0";"       0";"       0";"       0";"       0";"       0"
"Rotterdam The Hague Airport";"2014 March";"    2611";"    2227";"     796";"     720";"      76";"     818";"     719";"      99";"   69576";"   67927";"    1649";"   65654";"   64030";"    1624";"  135230";"  132109";"  119066";"   13043";"    3121";"    3121";"    3121";"       0";"       0";"       0";"       0";"       0";"       0";"       0";"       0";"       0";"       0";"       0";"       0";"       0";"       0";"       0"
"Rotterdam The Hague Airport";"2014 April";"    2491";"    2138";"     775";"     673";"     102";"     781";"     674";"     107";"   63337";"   60919";"    2418";"   72064";"   68013";"    4051";"  135401";"  131975";"  122327";"    9648";"    3426";"    3426";"    3426";"       0";"       0";"       0";"       0";"       0";"       0";"       0";"       0";"       0";"       0";"       0";"       0";"       0";"       0";"       0"
"Rotterdam The Hague Airport";"2014 May";"    2874";"    1973";"     899";"     753";"     146";"     903";"     753";"     150";"   85735";"   77112";"    8623";"   86125";"   76550";"    9575";"  171860";"  169682";"  153899";"   15783";"    2178";"    2178";"    2178";"       0";"       0";"       0";"       0";"       0";"       0";"       0";"       0";"       0";"       0";"       0";"       0";"       0";"       0";"       0"
"Rotterdam The Hague Airport";"2014 June";"    2931";"    2031";"     907";"     742";"     165";"     915";"     743";"     172";"   86198";"   77191";"    9007";"   83662";"   75710";"    7952";"  169860";"  169640";"  155334";"   14306";"     220";"     220";"     220";"       0";"       0";"       0";"       0";"       0";"       0";"       0";"       0";"       0";"       0";"       0";"       0";"       0";"       0";"       0"
"Rotterdam The Hague Airport";"2014 July";"    2603";"    1702";"     862";"     692";"     170";"     863";"     694";"     169";"   67043";"   59621";"    7422";"   80219";"   70337";"    9882";"  147262";"  144796";"  129975";"   14821";"    2466";"    2130";"    2093";"      37";"       0";"       0";"       0";"      96";"       0";"       0";"      96";"     240";"     240";"       0";"       0";"       0";"       0";"       0"
"Rotterdam The Hague Airport";"2014 August";"    2353";"    1704";"     778";"     618";"     160";"     803";"     624";"     179";"   80810";"   68084";"   12726";"   72301";"   60781";"   11520";"  153111";"  149026";"  128995";"   20031";"    4085";"    2824";"    2824";"       0";"       0";"       0";"       0";"       0";"       0";"       0";"       0";"    1261";"    1261";"       0";"       0";"       0";"       0";"       0"
"Rotterdam The Hague Airport";"2014 September";"    2892";"    1954";"     949";"     756";"     193";"     942";"     758";"     184";"   88864";"   78547";"   10317";"   86585";"   76624";"    9961";"  175449";"  173494";"  156038";"   17456";"    1955";"    1955";"    1955";"       0";"       0";"       0";"       0";"       0";"       0";"       0";"       0";"       0";"       0";"       0";"       0";"       0";"       0";"       0"
"Rotterdam The Hague Airport";"2014 October";"    2432";"    1518";"     843";"     714";"     129";"     858";"     714";"     144";"   83232";"   75422";"    7810";"   74906";"   69310";"    5596";"  158138";"  156860";"  141031";"   15829";"    1278";"    1278";"    1278";"       0";"       0";"       0";"       0";"       0";"       0";"       0";"       0";"       0";"       0";"       0";"       0";"       0";"       0";"       0"
"Rotterdam The Hague Airport";"2014 November";"    1862";"    1576";"     584";"     500";"      84";"     589";"     503";"      86";"   43055";"   41468";"    1587";"   39549";"   37911";"    1638";"   82604";"   82604";"   75948";"    6656";"       0";"       0";"       0";"       0";"       0";"       0";"       0";"       0";"       0";"       0";"       0";"       0";"       0";"       0";"       0";"       0";"       0";"       0"
"Rotterdam The Hague Airport";"2014 December";"    1722";"    1126";"     618";"     537";"      81";"     604";"     541";"      63";"   44167";"   42732";"    1435";"   50990";"   49472";"    1518";"   95157";"   94708";"   86083";"    8625";"     449";"     449";"     449";"       0";"       0";"       0";"       0";"       0";"       0";"       0";"       0";"       0";"       0";"       0";"       0";"       0";"       0";"       0"
"Rotterdam The Hague Airport";"2015 January";"    1602";"    1060";"     570";"     515";"      55";"     574";"     516";"      58";"   43775";"   42661";"    1114";"   40960";"   39792";"    1168";"   84735";"   84582";"   76352";"    8230";"     153";"     153";"     153";"       0";"       0";"       0";"       0";"       0";"       0";"       0";"       0";"       0";"       0";"       0";"       0";"       0";"       0";"       0"
"Rotterdam The Hague Airport";"2015 February";"    1864";"    1512";"     632";"     570";"      62";"     631";"     563";"      68";"   49394";"   46577";"    2817";"   53030";"   50442";"    2588";"  102424";"  101790";"   94371";"    7419";"     634";"     634";"     634";"       0";"       0";"       0";"       0";"       0";"       0";"       0";"       0";"       0";"       0";"       0";"       0";"       0";"       0";"       0"
"Rotterdam The Hague Airport";"2015 March";"    2348";"    1626";"     766";"     683";"      83";"     764";"     673";"      91";"   65385";"   63024";"    2361";"   61352";"   58950";"    2402";"  126737";"  125849";"  116430";"    9419";"     888";"     888";"     888";"       0";"       0";"       0";"       0";"       0";"       0";"       0";"       0";"       0";"       0";"       0";"       0";"       0";"       0";"       0"
"Rotterdam The Hague Airport";"2015 April";"    2596";"    2284";"     816";"     691";"     125";"     813";"     697";"     116";"   62045";"   58461";"    3584";"   72236";"   67018";"    5218";"  134281";"  131289";"  121690";"    9599";"    2992";"    2992";"    2992";"       0";"       0";"       0";"       0";"       0";"       0";"       0";"       0";"       0";"       0";"       0";"       0";"       0";"       0";"       0"
"Rotterdam The Hague Airport";"2015 May";"    2952";"    1966";"     975";"     822";"     153";"     983";"     824";"     159";"   95368";"   85798";"    9570";"   95273";"   84955";"   10318";"  190641";"  187591";"  169241";"   18350";"    3050";"    3050";"    3050";"       0";"       0";"       0";"       0";"       0";"       0";"       0";"       0";"       0";"       0";"       0";"       0";"       0";"       0";"       0"
"Rotterdam The Hague Airport";"2015 June";"    3141";"    2212";"     996";"     830";"     166";"     995";"     830";"     165";"   90135";"   80608";"    9527";"   90163";"   81170";"    8993";"  180298";"  177952";"  162599";"   15353";"    2346";"    2346";"    2346";"       0";"       0";"       0";"       0";"       0";"       0";"       0";"       0";"       0";"       0";"       0";"       0";"       0";"       0";"       0"
"Rotterdam The Hague Airport";"2015 July";"    2792";"    1834";"     886";"     705";"     181";"     895";"     705";"     190";"   70204";"   61577";"    8627";"   85760";"   71136";"   14624";"  155964";"  152700";"  132953";"   19747";"    3264";"    3239";"    2921";"     318";"       0";"       0";"       0";"       0";"       0";"       0";"       0";"      25";"      25";"       0";"       0";"       0";"       0";"       0"
"Rotterdam The Hague Airport";"2015 August";"    2678";"    2126";"     840";"     674";"     166";"     848";"     675";"     173";"   88826";"   73304";"   15522";"   75021";"   63900";"   11121";"  163847";"  159100";"  136222";"   22878";"    4747";"    4747";"    4186";"     561";"       0";"       0";"       0";"       0";"       0";"       0";"       0";"       0";"       0";"       0";"       0";"       0";"       0";"       0"
"Rotterdam The Hague Airport";"2015 September";"    2880";"    1812";"     977";"     799";"     178";"     973";"     800";"     173";"   90050";"   81069";"    8981";"   88467";"   79618";"    8849";"  178517";"  175359";"  159628";"   15731";"    3158";"    3158";"    2888";"     270";"       0";"       0";"       0";"       0";"       0";"       0";"       0";"       0";"       0";"       0";"       0";"       0";"       0";"       0"
"Rotterdam The Hague Airport";"2015 October";"    2607";"    1978";"     861";"     738";"     123";"     877";"     736";"     141";"   80438";"   72958";"    7480";"   72540";"   66577";"    5963";"  152978";"  150170";"  135717";"   14453";"    2808";"    2808";"    2703";"     105";"       0";"       0";"       0";"       0";"       0";"       0";"       0";"       0";"       0";"       0";"       0";"       0";"       0";"       0"
"Rotterdam The Hague Airport";"2015 November";"    1845";"    1528";"     611";"     537";"      74";"     612";"     522";"      90";"   45535";"   44135";"    1400";"   39656";"   38235";"    1421";"   85191";"   85191";"   80280";"    4911";"       0";"       0";"       0";"       0";"       0";"       0";"       0";"       0";"       0";"       0";"       0";"       0";"       0";"       0";"       0";"       0";"       0";"       0"
"Rotterdam The Hague Airport";"2015 December";"    1839";"    1749";"     569";"     502";"      67";"     558";"     506";"      52";"   39679";"   38290";"    1389";"   44091";"   42750";"    1341";"   83770";"   83466";"   77975";"    5491";"     304";"     304";"       0";"     304";"       0";"       0";"       0";"       0";"       0";"       0";"       0";"       0";"       0";"       0";"       0";"       0";"       0";"       0"
"Rotterdam The Hague Airport";"2016 January";"    1670";"    1346";"     576";"     539";"      37";"     588";"     535";"      53";"   45699";"   44517";"    1182";"   42820";"   41568";"    1252";"   88519";"   87969";"   80711";"    7258";"     550";"     550";"       0";"     550";"       0";"       0";"       0";"       0";"       0";"       0";"       0";"       0";"       0";"       0";"       0";"       0";"       0";"       0"
"Rotterdam The Hague Airport";"2016 February";"    2072";"    1586";"     698";"     629";"      69";"     701";"     628";"      73";"   52229";"   50518";"    1711";"   54743";"   53176";"    1567";"  106972";"  106516";"   99714";"    6802";"     456";"     456";"       0";"     456";"       0";"       0";"       0";"       0";"       0";"       0";"       0";"       0";"       0";"       0";"       0";"       0";"       0";"       0"
"Rotterdam The Hague Airport";"2016 March";"    2478";"    1930";"     804";"     717";"      87";"     803";"     719";"      84";"   64426";"   62774";"    1652";"   63565";"   61822";"    1743";"  127991";"  127670";"  119517";"    8153";"     321";"     321";"     246";"      75";"       0";"       0";"       0";"       0";"       0";"       0";"       0";"       0";"       0";"       0";"       0";"       0";"       0";"       0"
"Rotterdam The Hague Airport";"2016 April";"    2575";"    2424";"     822";"     745";"      77";"     824";"     747";"      77";"   63706";"   62998";"     708";"   74345";"   72827";"    1518";"  138051";"  135060";"  126652";"    8408";"    2991";"    2991";"    2800";"     191";"       0";"       0";"       0";"       0";"       0";"       0";"       0";"       0";"       0";"       0";"       0";"       0";"       0";"       0"
"Rotterdam The Hague Airport";"2016 May";"    2891";"    2300";"     949";"     858";"      91";"     960";"     853";"     107";"   93465";"   90039";"    3426";"   90953";"   87301";"    3652";"  184418";"  181699";"  169045";"   12654";"    2719";"    2719";"    2719";"       0";"       0";"       0";"       0";"       0";"       0";"       0";"       0";"       0";"       0";"       0";"       0";"       0";"       0";"       0"
"Rotterdam The Hague Airport";"2016 June";"    2836";"    2106";"     927";"     820";"     107";"     940";"     819";"     121";"   87930";"   84450";"    3480";"   88778";"   85536";"    3242";"  176708";"  174172";"  165674";"    8498";"    2536";"    2536";"    2536";"       0";"       0";"       0";"       0";"       0";"       0";"       0";"       0";"       0";"       0";"       0";"       0";"       0";"       0";"       0"
"Rotterdam The Hague Airport";"2016 July";"    2785";"    2258";"     882";"     758";"     124";"     883";"     776";"     107";"   74515";"   72505";"    2010";"   87978";"   85014";"    2964";"  162493";"  159890";"  144552";"   15338";"    2603";"    2603";"    2603";"       0";"       0";"       0";"       0";"       0";"       0";"       0";"       0";"       0";"       0";"       0";"       0";"       0";"       0";"       0"
"Rotterdam The Hague Airport";"2016 August";"    2722";"    2319";"     859";"     766";"      93";"     864";"     764";"     100";"   85739";"   81826";"    3913";"   75659";"   72953";"    2706";"  161398";"  158747";"  141981";"   16766";"    2651";"    2651";"    2651";"       0";"       0";"       0";"       0";"       0";"       0";"       0";"       0";"       0";"       0";"       0";"       0";"       0";"       0";"       0"
"Rotterdam The Hague Airport";"2016 September";"    2899";"    2240";"     928";"     831";"      97";"     944";"     828";"     116";"   85312";"   83393";"    1919";"   83672";"   81598";"    2074";"  168984";"  166351";"  157894";"    8457";"    2633";"    2633";"    2633";"       0";"       0";"       0";"       0";"       0";"       0";"       0";"       0";"       0";"       0";"       0";"       0";"       0";"       0";"       0"
"Rotterdam The Hague Airport";"2016 October";"    2596";"    1902";"     857";"     774";"      83";"     861";"     769";"      92";"   74663";"   73302";"    1361";"   68152";"   67398";"     754";"  142815";"  140076";"  132747";"    7329";"    2739";"    2739";"    2739";"       0";"       0";"       0";"       0";"       0";"       0";"       0";"       0";"       0";"       0";"       0";"       0";"       0";"       0";"       0"
"Rotterdam The Hague Airport";"2016 November";"    1888";"    1656";"     607";"     549";"      58";"     606";"     551";"      55";"   48098";"   47644";"     454";"   45758";"   45086";"     672";"   93856";"   93806";"   93515";"     291";"      50";"      50";"      50";"       0";"       0";"       0";"       0";"       0";"       0";"       0";"       0";"       0";"       0";"       0";"       0";"       0";"       0";"       0"
"Rotterdam The Hague Airport";"2016 December";"    1745";"    1305";"     583";"     524";"      59";"     589";"     532";"      57";"   42944";"   42375";"     569";"   48844";"   48328";"     516";"   91788";"   91738";"   90712";"    1026";"      50";"       0";"       0";"       0";"       0";"       0";"       0";"       0";"       0";"       0";"       0";"      50";"      50";"       0";"       0";"       0";"       0";"       0"
"Rotterdam The Hague Airport";"2017 January";"    1844";"    1396";"     586";"     529";"      57";"     593";"     529";"      64";"   50465";"   50004";"     461";"   49338";"   48893";"     445";"   99803";"   99803";"   98685";"    1118";"       0";"       0";"       0";"       0";"       0";"       0";"       0";"       0";"       0";"       0";"       0";"       0";"       0";"       0";"       0";"       0";"       0";"       0"
"Rotterdam The Hague Airport";"2017 February";"    1797";"    1282";"     587";"     519";"      68";"     580";"     519";"      61";"   47975";"   47527";"     448";"   52128";"   51836";"     292";"  100103";"  100034";"   98314";"    1720";"      69";"      68";"       0";"      68";"       0";"       0";"       0";"       0";"       0";"       0";"       0";"       1";"       1";"       0";"       0";"       0";"       0";"       0"
"Rotterdam The Hague Airport";"2017 March";"    2217";"    2320";"     655";"     580";"      75";"     672";"     582";"      90";"   62047";"   61401";"     646";"   59381";"   58636";"     745";"  121428";"  121329";"  118857";"    2472";"      99";"      99";"       0";"      99";"       0";"       0";"       0";"       0";"       0";"       0";"       0";"       0";"       0";"       0";"       0";"       0";"       0";"       0"
"Rotterdam The Hague Airport";"2017 April";"    2386";"    2394";"     723";"     644";"      79";"     711";"     644";"      67";"   72466";"   71321";"    1145";"   81404";"   80043";"    1361";"  153870";"  148860";"  147841";"    1019";"    5010";"    5010";"    4382";"     628";"       0";"       0";"       0";"       0";"       0";"       0";"       0";"       0";"       0";"       0";"       0";"       0";"       0";"       0"
"Rotterdam The Hague Airport";"2017 May";"    2765";"    2424";"     856";"     699";"     157";"     862";"     697";"     165";"   95023";"   90849";"    4174";"   95697";"   90883";"    4814";"  190720";"  185839";"  183923";"    1916";"    4881";"    4881";"    4336";"     545";"       0";"       0";"       0";"       0";"       0";"       0";"       0";"       0";"       0";"       0";"       0";"       0";"       0";"       0"
"Rotterdam The Hague Airport";"2017 June";"    2713";"    2496";"     792";"     664";"     128";"     805";"     666";"     139";"   92354";"   89193";"    3161";"   94137";"   90674";"    3463";"  186491";"  183160";"  181265";"    1895";"    3331";"    3331";"    2809";"     522";"       0";"       0";"       0";"       0";"       0";"       0";"       0";"       0";"       0";"       0";"       0";"       0";"       0";"       0"
"Rotterdam The Hague Airport";"2017 July";"    2526";"    2286";"     781";"     640";"     141";"     794";"     644";"     150";"   89801";"   85108";"    4693";"  103410";"   96569";"    6841";"  193211";"  186801";"  183153";"    3648";"    6410";"    6410";"    5151";"    1259";"       0";"       0";"       0";"       0";"       0";"       0";"       0";"       0";"       0";"       0";"       0";"       0";"       0";"       0"
"Rotterdam The Hague Airport";"2017 August";"    2520";"    2412";"     779";"     647";"     132";"     785";"     647";"     138";"  102032";"   95156";"    6876";"   93269";"   87720";"    5549";"  195301";"  187308";"  182684";"    4624";"    7993";"    7993";"    6902";"    1091";"       0";"       0";"       0";"       0";"       0";"       0";"       0";"       0";"       0";"       0";"       0";"       0";"       0";"       0"
"Rotterdam The Hague Airport";"2017 September";"    2366";"    2256";"     765";"     655";"     110";"     771";"     656";"     115";"   95455";"   91282";"    4173";"   93392";"   89890";"    3502";"  188847";"  184290";"  182183";"    2107";"    4557";"    4557";"    4557";"       0";"       0";"       0";"       0";"       0";"       0";"       0";"       0";"       0";"       0";"       0";"       0";"       0";"       0";"       0"
"Rotterdam The Hague Airport";"2017 October";"    2280";"    1942";"     731";"     620";"     111";"     742";"     619";"     123";"   82035";"   80642";"    1393";"   75957";"   74648";"    1309";"  157992";"  154210";"  152400";"    1810";"    3782";"    3782";"    3782";"       0";"       0";"       0";"       0";"       0";"       0";"       0";"       0";"       0";"       0";"       0";"       0";"       0";"       0";"       0"
"Rotterdam The Hague Airport";"2017 November";"    1489";"    1566";"     421";"     325";"      96";"     427";"     328";"      99";"   37052";"   33978";"    3074";"   33889";"   31615";"    2274";"   70941";"   67360";"   67175";"     185";"    3581";"    3215";"    3215";"       0";"       0";"       0";"       0";"     310";"       0";"     310";"       0";"      56";"      56";"       0";"       0";"       0";"       0";"       0"
"Rotterdam The Hague Airport";"2017 December";"    1346";"     927";"     423";"     358";"      65";"     429";"     351";"      78";"   34776";"   33366";"    1410";"   39209";"   37313";"    1896";"   73985";"   72207";"   70808";"    1399";"    1778";"    1612";"    1436";"     176";"       0";"       0";"       0";"       0";"       0";"       0";"       0";"     166";"     166";"       0";"       0";"       0";"       0";"       0"
"Rotterdam The Hague Airport";"2018 January";"    1558";"    1310";"     493";"     440";"      53";"     495";"     434";"      61";"   45124";"   44082";"    1042";"   43897";"   43209";"     688";"   89021";"   86830";"   85192";"    1638";"    2191";"    1551";"    1405";"     146";"       0";"       0";"       0";"     640";"     228";"     412";"       0";"       0";"       0";"       0";"       0";"       0";"       0";"       0"
"Rotterdam The Hague Airport";"2018 February";"    1821";"    1970";"     498";"     403";"      95";"     490";"     404";"      86";"   42614";"   41137";"    1477";"   45879";"   44066";"    1813";"   88493";"   87155";"   85499";"    1656";"    1338";"    1338";"    1338";"       0";"       0";"       0";"       0";"       0";"       0";"       0";"       0";"       0";"       0";"       0";"       0";"       0";"       0";"       0"
"Rotterdam The Hague Airport";"2018 March";"    2087";"    2064";"     597";"     523";"      74";"     601";"     521";"      80";"   61646";"   59914";"    1732";"   59887";"   58130";"    1757";"  121533";"  119180";"  115953";"    3227";"    2353";"    2160";"    2160";"       0";"       0";"       0";"       0";"       0";"       0";"       0";"       0";"     193";"     193";"       0";"       0";"       0";"       0";"       0"
"Rotterdam The Hague Airport";"2018 April";"    2455";"    2380";"     733";"     596";"     137";"     728";"     599";"     129";"   66040";"   62929";"    3111";"   78168";"   72778";"    5390";"  144208";"  139027";"  132736";"    6291";"    5181";"    5181";"    5181";"       0";"       0";"       0";"       0";"       0";"       0";"       0";"       0";"       0";"       0";"       0";"       0";"       0";"       0";"       0"
"Rotterdam The Hague Airport";"2018 May";"    3105";"    2358";"     971";"     830";"     141";"     993";"     828";"     165";"  109712";"  102917";"    6795";"  111438";"  104351";"    7087";"  221150";"  216789";"  205776";"   11013";"    4361";"    4361";"    4361";"       0";"       0";"       0";"       0";"       0";"       0";"       0";"       0";"       0";"       0";"       0";"       0";"       0";"       0";"       0"
"Rotterdam The Hague Airport";"2018 June";"    3225";"    2368";"     953";"     796";"     157";"     968";"     792";"     176";"  107243";"  103013";"    4230";"  110496";"  103930";"    6566";"  217739";"  213558";"  207936";"    5622";"    4181";"    4181";"    4181";"       0";"       0";"       0";"       0";"       0";"       0";"       0";"       0";"       0";"       0";"       0";"       0";"       0";"       0";"       0"
"Rotterdam The Hague Airport";"2018 July";"    3126";"    2540";"     951";"     769";"     182";"     946";"     768";"     178";"  106713";"   99021";"    7692";"  123922";"  111875";"   12047";"  230635";"  223614";"  212897";"   10717";"    7021";"    6030";"    6030";"       0";"       0";"       0";"       0";"     251";"     251";"       0";"       0";"     740";"     740";"       0";"       0";"       0";"       0";"       0"
"Rotterdam The Hague Airport";"2018 August";"    2804";"    2090";"     924";"     759";"     165";"     940";"     761";"     179";"  122246";"  109026";"   13220";"  110553";"   99981";"   10572";"  232799";"  226649";"  211885";"   14764";"    6150";"    5364";"    5364";"       0";"       0";"       0";"       0";"       0";"       0";"       0";"       0";"     786";"     786";"       0";"       0";"       0";"       0";"       0"
"Rotterdam The Hague Airport";"2018 September";"    2920";"    2072";"     939";"     789";"     150";"     940";"     783";"     157";"  112043";"  106340";"    5703";"  110984";"  104740";"    6244";"  223027";"  217909";"  211607";"    6302";"    5118";"    4964";"    4964";"       0";"       0";"       0";"       0";"       0";"       0";"       0";"       0";"     154";"     154";"       0";"       0";"       0";"       0";"       0"
"Rotterdam The Hague Airport";"2018 October";"    2768";"    2058";"     877";"     740";"     137";"     886";"     732";"     154";"  102562";"   95686";"    6876";"   91368";"   84034";"    7334";"  193930";"  187049";"  177580";"    9469";"    6881";"    6881";"    6881";"       0";"       0";"       0";"       0";"       0";"       0";"       0";"       0";"       0";"       0";"       0";"       0";"       0";"       0";"       0"
"Rotterdam The Hague Airport";"2018 November";"    1705";"    1808";"     440";"     349";"      91";"     444";"     349";"      95";"   37959";"   35163";"    2796";"   35286";"   33088";"    2198";"   73245";"   69196";"   68985";"     211";"    4049";"    4049";"    4049";"       0";"       0";"       0";"       0";"       0";"       0";"       0";"       0";"       0";"       0";"       0";"       0";"       0";"       0";"       0"
"Rotterdam The Hague Airport";"2018 December";"    1373";"    1316";"     402";"     334";"      68";"     406";"     338";"      68";"   33519";"   31193";"    2326";"   38859";"   36883";"    1976";"   72378";"   68617";"   65555";"    3062";"    3761";"    3761";"    3761";"       0";"       0";"       0";"       0";"       0";"       0";"       0";"       0";"       0";"       0";"       0";"       0";"       0";"       0";"       0"
"Rotterdam The Hague Airport";"2019 January";"    1607";"    1408";"     471";"     396";"      75";"     467";"     393";"      74";"   42870";"   39631";"    3239";"   41186";"   38565";"    2621";"   84056";"   79966";"   75090";"    4876";"    4090";"    3614";"    3614";"       0";"       0";"       0";"       0";"       0";"       0";"       0";"       0";"     476";"     476";"       0";"       0";"       0";"       0";"       0"
"Rotterdam The Hague Airport";"2019 February";"    1858";"    1676";"     491";"     416";"      75";"     487";"     416";"      71";"   45623";"   41987";"    3636";"   49797";"   45866";"    3931";"   95420";"   91161";"   83748";"    7413";"    4259";"    4259";"    4259";"       0";"       0";"       0";"       0";"       0";"       0";"       0";"       0";"       0";"       0";"       0";"       0";"       0";"       0";"       0"
"Rotterdam The Hague Airport";"2019 March";"    2138";"    1896";"     642";"     550";"      92";"     644";"     549";"      95";"   70235";"   66183";"    4052";"   67448";"   63396";"    4052";"  137683";"  130992";"  121959";"    9033";"    6691";"    6691";"    6691";"       0";"       0";"       0";"       0";"       0";"       0";"       0";"       0";"       0";"       0";"       0";"       0";"       0";"       0";"       0"
"Rotterdam The Hague Airport";"2019 April";"    2642";"    2320";"     782";"     659";"     123";"     774";"     674";"     100";"   77152";"   72367";"    4785";"   91990";"   86446";"    5544";"  169142";"  159234";"  150456";"    8778";"    9908";"    9908";"    9908";"       0";"       0";"       0";"       0";"       0";"       0";"       0";"       0";"       0";"       0";"       0";"       0";"       0";"       0";"       0"
"Rotterdam The Hague Airport";"2019 May";"    3194";"    2196";"    1000";"     854";"     146";"    1011";"     862";"     149";"  112360";"  107018";"    5342";"  115077";"  110610";"    4467";"  227437";"  221218";"  209625";"   11593";"    6219";"    6219";"    6219";"       0";"       0";"       0";"       0";"       0";"       0";"       0";"       0";"       0";"       0";"       0";"       0";"       0";"       0";"       0"
"Rotterdam The Hague Airport";"2019 June";"    3197";"    2170";"     974";"     831";"     143";"     969";"     832";"     137";"  118538";"  112933";"    5605";"  121531";"  114795";"    6736";"  240069";"  231448";"  218310";"   13138";"    8621";"    8621";"    8621";"       0";"       0";"       0";"       0";"       0";"       0";"       0";"       0";"       0";"       0";"       0";"       0";"       0";"       0";"       0"
"Rotterdam The Hague Airport";"2019 July";"    3212";"    2120";"    1017";"     832";"     185";"    1022";"     835";"     187";"  113281";"  105557";"    7724";"  137793";"  122479";"   15314";"  251074";"  238037";"  217858";"   20179";"   13037";"   13037";"   13037";"       0";"       0";"       0";"       0";"       0";"       0";"       0";"       0";"       0";"       0";"       0";"       0";"       0";"       0";"       0"
"Rotterdam The Hague Airport";"2019 August";"    3185";"    1948";"    1045";"     839";"     206";"    1054";"     838";"     216";"  142244";"  122700";"   19544";"  127614";"  112589";"   15025";"  269858";"  252335";"  224553";"   27782";"   17523";"   17358";"   17358";"       0";"       0";"       0";"       0";"       0";"       0";"       0";"       0";"     165";"     165";"       0";"       0";"       0";"       0";"       0"
"Rotterdam The Hague Airport";"2019 September";"    3020";"    1884";"    1003";"     826";"     177";"     994";"     826";"     168";"  122672";"  112551";"   10121";"  117934";"  111254";"    6680";"  240606";"  229982";"  215278";"   14704";"   10624";"   10624";"   10624";"       0";"       0";"       0";"       0";"       0";"       0";"       0";"       0";"       0";"       0";"       0";"       0";"       0";"       0";"       0"
"Rotterdam The Hague Airport";"2019 October";"    2739";"    1766";"     885";"     737";"     148";"     886";"     729";"     157";"  107016";"   98935";"    8081";"   91576";"   85513";"    6063";"  198592";"  187377";"  174085";"   13292";"   11215";"   11215";"   11215";"       0";"       0";"       0";"       0";"       0";"       0";"       0";"       0";"       0";"       0";"       0";"       0";"       0";"       0";"       0"
"Rotterdam The Hague Airport";"2019 November";"    1769";"    1569";"     454";"     365";"      89";"     456";"     365";"      91";"   48123";"   44380";"    3743";"   43625";"   40573";"    3052";"   91748";"   83215";"   76334";"    6881";"    8533";"    8533";"    8533";"       0";"       0";"       0";"       0";"       0";"       0";"       0";"       0";"       0";"       0";"       0";"       0";"       0";"       0";"       0"
"Rotterdam The Hague Airport";"2019 December";"    1539";"    1292";"     439";"     375";"      64";"     439";"     375";"      64";"   41797";"   39599";"    2198";"   47316";"   44773";"    2543";"   89113";"   81414";"   73012";"    8402";"    7699";"    7699";"    7699";"       0";"       0";"       0";"       0";"       0";"       0";"       0";"       0";"       0";"       0";"       0";"       0";"       0";"       0";"       0"
"Rotterdam The Hague Airport";"2020 January*";"    1607";"    1078";"     481";"     418";"      63";"     482";"     413";"      69";"   51119";"   47572";"    3547";"   47961";"   45773";"    2188";"   99080";"   90361";"   82120";"    8241";"    8719";"    8719";"    8719";"       0";"       0";"       0";"       0";"       0";"       0";"       0";"       0";"       0";"       0";"       0";"       0";"       0";"       0";"       0"
"Rotterdam The Hague Airport";"2020 February*";"    1640";"    1100";"     506";"     421";"      85";"     525";"     427";"      98";"   49988";"   46769";"    3219";"   54074";"   51143";"    2931";"  104062";"   97069";"   88934";"    8135";"    6993";"    6993";"    6993";"       0";"       0";"       0";"       0";"       0";"       0";"       0";"       0";"       0";"       0";"       0";"       0";"       0";"       0";"       0"
"Rotterdam The Hague Airport";"2020 March*";"    1500";"    1672";"     369";"     322";"      47";"     379";"     311";"      68";"   36664";"   35338";"    1326";"   26206";"   25012";"    1194";"   62870";"   57788";"   53433";"    4355";"    5082";"    5082";"    5082";"       0";"       0";"       0";"       0";"       0";"       0";"       0";"       0";"       0";"       0";"       0";"       0";"       0";"       0";"       0"
"Rotterdam The Hague Airport";"2020 April*";"     570";"    1058";"      17";"       0";"      17";"      24";"       0";"      24";"       0";"       0";"       0";"       0";"       0";"       0";"       0";"       0";"       0";"       0";"       0";"       0";"       0";"       0";"       0";"       0";"       0";"       0";"       0";"       0";"       0";"       0";"       0";"       0";"       0";"       0";"       0";"       0"
"Rotterdam The Hague Airport";"2020 May*";"     932";"    1852";"      19";"       0";"      19";"      27";"       0";"      27";"      78";"       0";"      78";"      56";"       0";"      56";"     134";"     134";"     134";"       0";"       0";"       0";"       0";"       0";"       0";"       0";"       0";"       0";"       0";"       0";"       0";"       0";"       0";"       0";"       0";"       0";"       0";"       0"
"Rotterdam The Hague Airport";"2020 June*";"    1160";"    2564";"      80";"      39";"      41";"      88";"      40";"      48";"    2072";"    1960";"     112";"    5899";"    5293";"     606";"    7971";"    7971";"    7041";"     930";"       0";"       0";"       0";"       0";"       0";"       0";"       0";"       0";"       0";"       0";"       0";"       0";"       0";"       0";"       0";"       0";"       0";"       0"
"Rotterdam The Hague Airport";"2020 July*";"    2152";"    2820";"     522";"     424";"      98";"     510";"     426";"      84";"   32511";"   31913";"     598";"   45957";"   42825";"    3132";"   78468";"   78468";"   74671";"    3797";"       0";"       0";"       0";"       0";"       0";"       0";"       0";"       0";"       0";"       0";"       0";"       0";"       0";"       0";"       0";"       0";"       0";"       0"
"Rotterdam The Hague Airport";"2020 August*";"    2087";"    2544";"     527";"     452";"      75";"     544";"     453";"      91";"   41749";"   38312";"    3437";"   32298";"   30192";"    2106";"   74047";"   74047";"   68565";"    5482";"       0";"       0";"       0";"       0";"       0";"       0";"       0";"       0";"       0";"       0";"       0";"       0";"       0";"       0";"       0";"       0";"       0";"       0"
"Rotterdam The Hague Airport";"2020 September*";"    1811";"    2534";"     315";"     234";"      81";"     320";"     234";"      86";"   17087";"   15538";"    1549";"   14960";"   14292";"     668";"   32047";"   31135";"   29077";"    2058";"     912";"     912";"     912";"       0";"       0";"       0";"       0";"       0";"       0";"       0";"       0";"       0";"       0";"       0";"       0";"       0";"       0";"       0"
"Rotterdam The Hague Airport";"2020 October*";"    1139";"    2068";"     176";"     122";"      54";"     177";"     122";"      55";"   11445";"   10943";"     502";"   10366";"    9549";"     817";"   21811";"   19216";"   19168";"      48";"    2595";"    2595";"    2595";"       0";"       0";"       0";"       0";"       0";"       0";"       0";"       0";"       0";"       0";"       0";"       0";"       0";"       0";"       0"
"Rotterdam The Hague Airport";"2020 November*";"     898";"    1897";"      62";"      23";"      39";"      72";"      24";"      48";"    2639";"    1716";"     923";"    2122";"    1200";"     922";"    4761";"    2365";"    2176";"     189";"    2396";"    2396";"    2396";"       0";"       0";"       0";"       0";"       0";"       0";"       0";"       0";"       0";"       0";"       0";"       0";"       0";"       0";"       0"
"Rotterdam The Hague Airport";"2020 December*";"     623";"    1272";"      63";"       5";"      58";"      52";"       6";"      46";"    1940";"     348";"    1592";"    2650";"     900";"    1750";"    4590";"     325";"     325";"       0";"    4265";"    4265";"    4265";"       0";"       0";"       0";"       0";"       0";"       0";"       0";"       0";"       0";"       0";"       0";"       0";"       0";"       0";"       0"
"Rotterdam The Hague Airport";"2021 January*";"     753";"     928";"      83";"       6";"      77";"      98";"       6";"      92";"    2053";"     601";"    1452";"    1258";"     321";"     937";"    3311";"      34";"       0";"      34";"    3277";"    3277";"    3277";"       0";"       0";"       0";"       0";"       0";"       0";"       0";"       0";"       0";"       0";"       0";"       0";"       0";"       0";"       0"
"Rotterdam The Hague Airport";"2021 February*";"     714";"    2090";"      74";"       5";"      69";"      70";"       3";"      67";"    1508";"     361";"    1147";"    1363";"     262";"    1101";"    2871";"       0";"       0";"       0";"    2871";"    2871";"    2871";"       0";"       0";"       0";"       0";"       0";"       0";"       0";"       0";"       0";"       0";"       0";"       0";"       0";"       0";"       0"
"Rotterdam The Hague Airport";"2021 March*";"     972";"    2438";"      88";"       0";"      88";"      97";"       0";"      97";"      57";"       0";"      57";"      41";"       0";"      41";"      98";"      98";"      98";"       0";"       0";"       0";"       0";"       0";"       0";"       0";"       0";"       0";"       0";"       0";"       0";"       0";"       0";"       0";"       0";"       0";"       0";"       0"
"Rotterdam The Hague Airport";"2021 April*";"    1239";"    2708";"     100";"      12";"      88";"      95";"      12";"      83";"     642";"     385";"     257";"    1303";"     781";"     522";"    1945";"    1945";"    1166";"     779";"       0";"       0";"       0";"       0";"       0";"       0";"       0";"       0";"       0";"       0";"       0";"       0";"       0";"       0";"       0";"       0";"       0";"       0"
"Rotterdam The Hague Airport";"2021 May*";"    1263";"    2686";"     132";"      55";"      77";"     135";"      55";"      80";"    4045";"    3766";"     279";"    4867";"    4396";"     471";"    8912";"    8912";"    8162";"     750";"       0";"       0";"       0";"       0";"       0";"       0";"       0";"       0";"       0";"       0";"       0";"       0";"       0";"       0";"       0";"       0";"       0";"       0"
"Rotterdam The Hague Airport";"2021 June*";"    1700";"    2887";"     289";"     196";"      93";"     290";"     196";"      94";"   15981";"   14977";"    1004";"   23328";"   19649";"    3679";"   39309";"   33826";"   32653";"    1173";"    5483";"    5483";"    5483";"       0";"       0";"       0";"       0";"       0";"       0";"       0";"       0";"       0";"       0";"       0";"       0";"       0";"       0";"       0"
"Rotterdam The Hague Airport";"2021 July*";"    2406";"    2560";"     666";"     471";"     195";"     646";"     478";"     168";"   45390";"   42499";"    2891";"   68492";"   56755";"   11737";"  113882";"   98923";"   91688";"    7235";"   14959";"   14959";"   14959";"       0";"       0";"       0";"       0";"       0";"       0";"       0";"       0";"       0";"       0";"       0";"       0";"       0";"       0";"       0"
"Rotterdam The Hague Airport";"2021 August*";"    2665";"    2943";"     749";"     605";"     144";"     767";"     604";"     163";"   98121";"   86741";"   11380";"   83836";"   77879";"    5957";"  181957";"  164739";"  155694";"    9045";"   17218";"   17218";"   17218";"       0";"       0";"       0";"       0";"       0";"       0";"       0";"       0";"       0";"       0";"       0";"       0";"       0";"       0";"       0"
"Rotterdam The Hague Airport";"2021 September*";"    2630";"    2835";"     706";"     577";"     129";"     704";"     577";"     127";"   84608";"   79906";"    4702";"   82561";"   80272";"    2289";"  167169";"  158465";"  154626";"    3839";"    8704";"    8616";"    8616";"       0";"       0";"       0";"       0";"       0";"       0";"       0";"       0";"      88";"      88";"       0";"       0";"       0";"       0";"       0"
"Rotterdam The Hague Airport";"2021 October*";"    2367";"    2392";"     643";"     513";"     130";"     660";"     509";"     151";"   78845";"   75517";"    3328";"   68523";"   65635";"    2888";"  147368";"  141726";"  136483";"    5243";"    5642";"    5642";"    5642";"       0";"       0";"       0";"       0";"       0";"       0";"       0";"       0";"       0";"       0";"       0";"       0";"       0";"       0";"       0"
"Rotterdam The Hague Airport";"2021 November*";"    1502";"    2030";"     331";"     201";"     130";"     343";"     205";"     138";"   26319";"   24750";"    1569";"   21959";"   21127";"     832";"   48278";"   48278";"   43563";"    4715";"       0";"       0";"       0";"       0";"       0";"       0";"       0";"       0";"       0";"       0";"       0";"       0";"       0";"       0";"       0";"       0";"       0";"       0"
"Rotterdam The Hague Airport";"2021 December*";"    1060";"    1330";"     285";"     186";"      99";"     256";"     190";"      66";"   15463";"   15048";"     415";"   24832";"   24277";"     555";"   40295";"   40295";"   36141";"    4154";"       0";"       0";"       0";"       0";"       0";"       0";"       0";"       0";"       0";"       0";"       0";"       0";"       0";"       0";"       0";"       0";"       0";"       0"
"Rotterdam The Hague Airport";"2022 January*";"    1437";"    1358";"     356";"     248";"     108";"     378";"     247";"     131";"   31498";"   30769";"     729";"   27405";"   26933";"     472";"   58903";"   58903";"   51443";"    7460";"       0";"       0";"       0";"       0";"       0";"       0";"       0";"       0";"       0";"       0";"       0";"       0";"       0";"       0";"       0";"       0";"       0";"       0"
"Rotterdam The Hague Airport";"2022 February*";"    1514";"    1558";"     361";"     250";"     111";"     338";"     254";"      84";"   28697";"   28296";"     401";"   34813";"   34114";"     699";"   63510";"   62829";"   56943";"    5886";"     681";"     681";"     681";"       0";"       0";"       0";"       0";"       0";"       0";"       0";"       0";"       0";"       0";"       0";"       0";"       0";"       0";"       0"
"Rotterdam The Hague Airport";"2022 March*";"    2461";"    2962";"     485";"     390";"      95";"     504";"     391";"     113";"   52056";"   51206";"     850";"   49107";"   48344";"     763";"  101163";"   96857";"   88255";"    8602";"    4306";"    4306";"    4306";"       0";"       0";"       0";"       0";"       0";"       0";"       0";"       0";"       0";"       0";"       0";"       0";"       0";"       0";"       0"
"Rotterdam The Hague Airport";"2022 April*";"    2733";"    2558";"     721";"     561";"     160";"     716";"     573";"     143";"   62282";"   59844";"    2438";"   77026";"   73795";"    3231";"  139308";"  135457";"  120083";"   15374";"    3851";"    3813";"    3813";"       0";"       0";"       0";"       0";"      38";"      38";"       0";"       0";"       0";"       0";"       0";"       0";"       0";"       0";"       0"
"Rotterdam The Hague Airport";"2022 May*";"    3412";"    2744";"     979";"     788";"     191";"     995";"     791";"     204";"  111325";"  104491";"    6834";"  113389";"  106108";"    7281";"  224714";"  214554";"  185102";"   29452";"   10160";"   10160";"   10160";"       0";"       0";"       0";"       0";"       0";"       0";"       0";"       0";"       0";"       0";"       0";"       0";"       0";"       0";"       0"
"Rotterdam The Hague Airport";"2022 June*";"    3368";"    2482";"     931";"     728";"     203";"     927";"     732";"     195";"  107372";"  102501";"    4871";"  116697";"  108608";"    8089";"  224069";"  211028";"  182094";"   28934";"   13041";"   13041";"   13041";"       0";"       0";"       0";"       0";"       0";"       0";"       0";"       0";"       0";"       0";"       0";"       0";"       0";"       0";"       0"
"Rotterdam The Hague Airport";"2022 July*";"    3884";"    2550";"    1251";"     901";"     350";"    1214";"     914";"     300";"  139595";"  119869";"   19726";"  172873";"  140903";"   31970";"  312468";"  286338";"  207511";"   78827";"   26130";"   26130";"   26130";"       0";"       0";"       0";"       0";"       0";"       0";"       0";"       0";"       0";"       0";"       0";"       0";"       0";"       0";"       0"
"Rotterdam The Hague Airport";"2022 August*";"    3628";"    3064";"    1164";"     872";"     292";"    1189";"     875";"     314";"  164241";"  129386";"   34855";"  141130";"  116862";"   24268";"  305371";"  279646";"  199461";"   80185";"   25725";"   25725";"   25725";"       0";"       0";"       0";"       0";"       0";"       0";"       0";"       0";"       0";"       0";"       0";"       0";"       0";"       0";"       0"
"Rotterdam The Hague Airport";"2022 September*";"    3191";"    2358";"     967";"     742";"     225";"     960";"     745";"     215";"  114436";"  103520";"   10916";"  112454";"  104475";"    7979";"  226890";"  212330";"  172742";"   39588";"   14560";"   14560";"   14560";"       0";"       0";"       0";"       0";"       0";"       0";"       0";"       0";"       0";"       0";"       0";"       0";"       0";"       0";"       0"
"Rotterdam The Hague Airport";"2022 October*";"    3105";"    2048";"     950";"     785";"     165";"     964";"     789";"     175";"  120235";"  111227";"    9008";"  111988";"  105403";"    6585";"  232223";"  218824";"  176910";"   41914";"   13399";"   13399";"   13399";"       0";"       0";"       0";"       0";"       0";"       0";"       0";"       0";"       0";"       0";"       0";"       0";"       0";"       0";"       0"
"Rotterdam The Hague Airport";"2022 November*";"    1930";"    1851";"     514";"     423";"      91";"     523";"     424";"      99";"   60030";"   59157";"     873";"   56059";"   55382";"     677";"  116089";"   98454";"   73869";"   24585";"   17635";"   17307";"   17307";"       0";"       0";"       0";"       0";"       0";"       0";"       0";"       0";"     328";"     328";"       0";"       0";"       0";"       0";"       0"
"Eindhoven Airport";"1999 January";"    1350";"     344";"     488";"     459";"      29";"     503";"     475";"      28";"    7906";"    7421";"     485";"    8605";"    8359";"     246";"   16511";"   16331";"   15798";"     533";"     180";"       0";"       0";"       0";"       0";"       0";"       0";"       0";"       0";"       0";"       0";"       0";"       0";"       0";"       0";"       0";"     180";"       0"
"Eindhoven Airport";"1999 February";"    1272";"     200";"     468";"     440";"      28";"     476";"     454";"      22";"    8086";"    8007";"      79";"    9229";"    9008";"     221";"   17315";"   17315";"   16529";"     786";"       0";"       0";"       0";"       0";"       0";"       0";"       0";"       0";"       0";"       0";"       0";"       0";"       0";"       0";"       0";"       0";"       0";"       0"
"Eindhoven Airport";"1999 March";"    1655";"     404";"     599";"     549";"      50";"     601";"     554";"      47";"    9778";"    9491";"     287";"   11155";"   10854";"     301";"   20933";"   20933";"   20053";"     880";"       0";"       0";"       0";"       0";"       0";"       0";"       0";"       0";"       0";"       0";"       0";"       0";"       0";"       0";"       0";"       0";"       0";"       0"
"Eindhoven Airport";"1999 April";"    1731";"     491";"     603";"     582";"      21";"     611";"     582";"      29";"    9666";"    9553";"     113";"   11725";"   10686";"    1039";"   21391";"   21391";"   20237";"    1154";"       0";"       0";"       0";"       0";"       0";"       0";"       0";"       0";"       0";"       0";"       0";"       0";"       0";"       0";"       0";"       0";"       0";"       0"
"Eindhoven Airport";"1999 May";"    1737";"     574";"     617";"     564";"      53";"     615";"     566";"      49";"   12939";"    9366";"    3573";"   14997";"   10120";"    4877";"   27936";"   27936";"   23727";"    4209";"       0";"       0";"       0";"       0";"       0";"       0";"       0";"       0";"       0";"       0";"       0";"       0";"       0";"       0";"       0";"       0";"       0";"       0"
"Eindhoven Airport";"1999 June";"    1889";"     562";"     657";"     614";"      43";"     659";"     615";"      44";"   12902";"   10441";"    2461";"   15868";"   11592";"    4276";"   28770";"   28770";"   25912";"    2858";"       0";"       0";"       0";"       0";"       0";"       0";"       0";"       0";"       0";"       0";"       0";"       0";"       0";"       0";"       0";"       0";"       0";"       0"
"Eindhoven Airport";"1999 July";"    1795";"     680";"     646";"     595";"      51";"     645";"     596";"      49";"   12029";"    8421";"    3608";"   16267";"    9338";"    6929";"   28296";"   27501";"   20087";"    7414";"     795";"       0";"       0";"       0";"       0";"       0";"       0";"       0";"       0";"       0";"       0";"       0";"       0";"       0";"       0";"       0";"     795";"       0"
"Eindhoven Airport";"1999 August";"    1572";"     438";"     601";"     548";"      53";"     606";"     554";"      52";"   13342";"    7142";"    6200";"   12441";"    7809";"    4632";"   25783";"   25782";"   17287";"    8495";"       1";"       0";"       0";"       0";"       0";"       0";"       0";"       0";"       0";"       0";"       0";"       0";"       0";"       0";"       0";"       0";"       1";"       0"
"Eindhoven Airport";"1999 September";"    1875";"     562";"     664";"     609";"      55";"     669";"     614";"      55";"   14981";"   10230";"    4751";"   16640";"   11462";"    5178";"   31621";"   31621";"   26668";"    4953";"       0";"       0";"       0";"       0";"       0";"       0";"       0";"       0";"       0";"       0";"       0";"       0";"       0";"       0";"       0";"       0";"       0";"       0"
"Eindhoven Airport";"1999 October";"    1751";"     493";"     630";"     584";"      46";"     645";"     591";"      54";"   13043";"   10206";"    2837";"   14198";"   11361";"    2837";"   27241";"   27077";"   24624";"    2453";"     164";"       0";"       0";"       0";"       0";"       0";"       0";"       0";"       0";"       0";"       0";"       0";"       0";"       0";"       0";"       0";"     164";"       0"
"Eindhoven Airport";"1999 November";"    1787";"     307";"     676";"     656";"      20";"     675";"     660";"      15";"   11755";"   11299";"     456";"   12466";"   12145";"     321";"   24221";"   24221";"   23385";"     836";"       0";"       0";"       0";"       0";"       0";"       0";"       0";"       0";"       0";"       0";"       0";"       0";"       0";"       0";"       0";"       0";"       0";"       0"
"Eindhoven Airport";"1999 December";"    1419";"     251";"     536";"     518";"      18";"     540";"     520";"      20";"    9041";"    8724";"     317";"    9235";"    9066";"     169";"   18276";"   18276";"   17671";"     605";"       0";"       0";"       0";"       0";"       0";"       0";"       0";"       0";"       0";"       0";"       0";"       0";"       0";"       0";"       0";"       0";"       0";"       0"
"Eindhoven Airport";"2000 January";"    1572";"     212";"     619";"     605";"      14";"     618";"     608";"      10";"    9012";"    8889";"     123";"    9787";"    9607";"     180";"   18799";"   18799";"   18195";"     604";"       0";"       0";"       0";"       0";"       0";"       0";"       0";"       0";"       0";"       0";"       0";"       0";"       0";"       0";"       0";"       0";"       0";"       0"
"Eindhoven Airport";"2000 February";"    1739";"     200";"     660";"     644";"      16";"     663";"     644";"      19";"   10778";"   10565";"     213";"   11790";"   11537";"     253";"   22568";"   22568";"   21650";"     918";"       0";"       0";"       0";"       0";"       0";"       0";"       0";"       0";"       0";"       0";"       0";"       0";"       0";"       0";"       0";"       0";"       0";"       0"
"Eindhoven Airport";"2000 March";"    1797";"     192";"     697";"     688";"       9";"     698";"     685";"      13";"   11826";"   11750";"      76";"   12428";"   12313";"     115";"   24254";"   24254";"   23360";"     894";"       0";"       0";"       0";"       0";"       0";"       0";"       0";"       0";"       0";"       0";"       0";"       0";"       0";"       0";"       0";"       0";"       0";"       0"
"Eindhoven Airport";"2000 April";"    1641";"     347";"     650";"     622";"      28";"     648";"     622";"      26";"   10454";"   10324";"     130";"   12108";"   10919";"    1189";"   22562";"   22562";"   20929";"    1633";"       0";"       0";"       0";"       0";"       0";"       0";"       0";"       0";"       0";"       0";"       0";"       0";"       0";"       0";"       0";"       0";"       0";"       0"
"Eindhoven Airport";"2000 May";"    1994";"     240";"     798";"     716";"      82";"     797";"     721";"      76";"   17840";"   12363";"    5477";"   20673";"   13374";"    7299";"   38513";"   38513";"   32062";"    6451";"       0";"       0";"       0";"       0";"       0";"       0";"       0";"       0";"       0";"       0";"       0";"       0";"       0";"       0";"       0";"       0";"       0";"       0"
"Eindhoven Airport";"2000 June";"    1871";"     374";"     728";"     631";"      97";"     726";"     638";"      88";"   17122";"   10938";"    6184";"   18350";"   11651";"    6699";"   35472";"   35472";"   29195";"    6277";"       0";"       0";"       0";"       0";"       0";"       0";"       0";"       0";"       0";"       0";"       0";"       0";"       0";"       0";"       0";"       0";"       0";"       0"
"Eindhoven Airport";"2000 July";"    1687";"     230";"     696";"     636";"      60";"     692";"     632";"      60";"   13620";"    8709";"    4911";"   16419";"    9404";"    7015";"   30039";"   30039";"   20820";"    9219";"       0";"       0";"       0";"       0";"       0";"       0";"       0";"       0";"       0";"       0";"       0";"       0";"       0";"       0";"       0";"       0";"       0";"       0"
"Eindhoven Airport";"2000 August";"    1836";"     452";"     730";"     678";"      52";"     733";"     684";"      49";"   16483";"   10128";"    6355";"   15664";"   10472";"    5192";"   32147";"   32147";"   22829";"    9318";"       0";"       0";"       0";"       0";"       0";"       0";"       0";"       0";"       0";"       0";"       0";"       0";"       0";"       0";"       0";"       0";"       0";"       0"
"Eindhoven Airport";"2000 September";"    1815";"     206";"     722";"     657";"      65";"     719";"     657";"      62";"   19346";"   11185";"    8161";"   21410";"   12323";"    9087";"   40756";"   40756";"   31401";"    9355";"       0";"       0";"       0";"       0";"       0";"       0";"       0";"       0";"       0";"       0";"       0";"       0";"       0";"       0";"       0";"       0";"       0";"       0"
"Eindhoven Airport";"2000 October";"    1786";"     141";"     721";"     674";"      47";"     719";"     674";"      45";"   18146";"   11787";"    6359";"   17161";"   12305";"    4856";"   35307";"   35307";"   27115";"    8192";"       0";"       0";"       0";"       0";"       0";"       0";"       0";"       0";"       0";"       0";"       0";"       0";"       0";"       0";"       0";"       0";"       0";"       0"
"Eindhoven Airport";"2000 November";"    1551";"     149";"     617";"     593";"      24";"     620";"     598";"      22";"   11299";"   11012";"     287";"   12190";"   12061";"     129";"   23489";"   23489";"   22274";"    1215";"       0";"       0";"       0";"       0";"       0";"       0";"       0";"       0";"       0";"       0";"       0";"       0";"       0";"       0";"       0";"       0";"       0";"       0"
"Eindhoven Airport";"2000 December";"    1160";"     102";"     449";"     430";"      19";"     454";"     436";"      18";"    7907";"    7780";"     127";"    8793";"    8642";"     151";"   16700";"   16700";"   15849";"     851";"       0";"       0";"       0";"       0";"       0";"       0";"       0";"       0";"       0";"       0";"       0";"       0";"       0";"       0";"       0";"       0";"       0";"       0"
"Eindhoven Airport";"2001 January";"    1518";"     122";"     574";"     551";"      23";"     584";"     562";"      22";"    9259";"    9129";"     130";"   10400";"   10245";"     155";"   19659";"   19659";"   18770";"     889";"       0";"       0";"       0";"       0";"       0";"       0";"       0";"       0";"       0";"       0";"       0";"       0";"       0";"       0";"       0";"       0";"       0";"       0"
"Eindhoven Airport";"2001 February";"    1381";"     144";"     533";"     511";"      22";"     544";"     521";"      23";"    9427";"    9305";"     122";"   10642";"   10397";"     245";"   20069";"   20069";"   19293";"     776";"       0";"       0";"       0";"       0";"       0";"       0";"       0";"       0";"       0";"       0";"       0";"       0";"       0";"       0";"       0";"       0";"       0";"       0"
"Eindhoven Airport";"2001 March";"    1558";"     110";"     617";"     581";"      36";"     623";"     586";"      37";"   11277";"   10671";"     606";"   12111";"   11484";"     627";"   23388";"   23388";"   22478";"     910";"       0";"       0";"       0";"       0";"       0";"       0";"       0";"       0";"       0";"       0";"       0";"       0";"       0";"       0";"       0";"       0";"       0";"       0"
"Eindhoven Airport";"2001 April";"    1086";"     208";"     398";"     366";"      32";"     400";"     368";"      32";"    8771";"    8603";"     168";"   10596";"    9624";"     972";"   19367";"   19367";"   18628";"     739";"       0";"       0";"       0";"       0";"       0";"       0";"       0";"       0";"       0";"       0";"       0";"       0";"       0";"       0";"       0";"       0";"       0";"       0"
"Eindhoven Airport";"2001 May";"    1305";"     238";"     450";"     382";"      68";"     451";"     386";"      65";"   14929";"    8531";"    6398";"   17312";"    9472";"    7840";"   32241";"   32241";"   25257";"    6984";"       0";"       0";"       0";"       0";"       0";"       0";"       0";"       0";"       0";"       0";"       0";"       0";"       0";"       0";"       0";"       0";"       0";"       0"
"Eindhoven Airport";"2001 June";"    1248";"     306";"     456";"     406";"      50";"     461";"     409";"      52";"   13647";"    8373";"    5274";"   14114";"    9260";"    4854";"   27761";"   27761";"   22384";"    5377";"       0";"       0";"       0";"       0";"       0";"       0";"       0";"       0";"       0";"       0";"       0";"       0";"       0";"       0";"       0";"       0";"       0";"       0"
"Eindhoven Airport";"2001 July";"    1260";"     241";"     465";"     408";"      57";"     468";"     414";"      54";"   12050";"    6423";"    5627";"   14933";"    7074";"    7859";"   26983";"   26525";"   17589";"    8936";"     458";"       0";"       0";"       0";"       0";"       0";"       0";"     458";"     458";"       0";"       0";"       0";"       0";"       0";"       0";"       0";"       0";"       0"
"Eindhoven Airport";"2001 August";"    1278";"     320";"     499";"     444";"      55";"     497";"     443";"      54";"   13240";"    6922";"    6318";"   12857";"    7511";"    5346";"   26097";"   26097";"   17186";"    8911";"       0";"       0";"       0";"       0";"       0";"       0";"       0";"       0";"       0";"       0";"       0";"       0";"       0";"       0";"       0";"       0";"       0";"       0"
"Eindhoven Airport";"2001 September";"    1302";"     169";"     477";"     405";"      72";"     481";"     409";"      72";"   13641";"    7196";"    6445";"   15806";"    7889";"    7917";"   29447";"   29447";"   22452";"    6995";"       0";"       0";"       0";"       0";"       0";"       0";"       0";"       0";"       0";"       0";"       0";"       0";"       0";"       0";"       0";"       0";"       0";"       0"
"Eindhoven Airport";"2001 October";"    1365";"     168";"     496";"     439";"      57";"     497";"     445";"      52";"   13174";"    7850";"    5324";"   12553";"    8662";"    3891";"   25727";"   25727";"   19226";"    6501";"       0";"       0";"       0";"       0";"       0";"       0";"       0";"       0";"       0";"       0";"       0";"       0";"       0";"       0";"       0";"       0";"       0";"       0"
"Eindhoven Airport";"2001 November";"    1148";"     126";"     398";"     382";"      16";"     405";"     389";"      16";"    7840";"    7685";"     155";"    8798";"    8669";"     129";"   16638";"   16638";"   16638";"       0";"       0";"       0";"       0";"       0";"       0";"       0";"       0";"       0";"       0";"       0";"       0";"       0";"       0";"       0";"       0";"       0";"       0";"       0"
"Eindhoven Airport";"2001 December";"     779";"     144";"     289";"     279";"      10";"     284";"     277";"       7";"    5534";"    5342";"     192";"    5606";"    5556";"      50";"   11140";"   11140";"   11140";"       0";"       0";"       0";"       0";"       0";"       0";"       0";"       0";"       0";"       0";"       0";"       0";"       0";"       0";"       0";"       0";"       0";"       0";"       0"
"Eindhoven Airport";"2002 January";"    1059";"     142";"     416";"     396";"      20";"     418";"     399";"      19";"    6800";"    6683";"     117";"    7451";"    7326";"     125";"   14251";"   14251";"   14251";"       0";"       0";"       0";"       0";"       0";"       0";"       0";"       0";"       0";"       0";"       0";"       0";"       0";"       0";"       0";"       0";"       0";"       0";"       0"
"Eindhoven Airport";"2002 February";"    1085";"     122";"     388";"     366";"      22";"     388";"     367";"      21";"    7797";"    7133";"     664";"    8633";"    7663";"     970";"   16430";"   16430";"   15240";"    1190";"       0";"       0";"       0";"       0";"       0";"       0";"       0";"       0";"       0";"       0";"       0";"       0";"       0";"       0";"       0";"       0";"       0";"       0"
"Eindhoven Airport";"2002 March";"    1189";"     189";"     418";"     388";"      30";"     419";"     389";"      30";"    9270";"    7815";"    1455";"   10328";"    8387";"    1941";"   19598";"   19598";"   16739";"    2859";"       0";"       0";"       0";"       0";"       0";"       0";"       0";"       0";"       0";"       0";"       0";"       0";"       0";"       0";"       0";"       0";"       0";"       0"
"Eindhoven Airport";"2002 April";"    1230";"     216";"     465";"     410";"      55";"     464";"     411";"      53";"   14837";"   11148";"    3689";"   16783";"   12168";"    4615";"   31620";"   31620";"   24571";"    7049";"       0";"       0";"       0";"       0";"       0";"       0";"       0";"       0";"       0";"       0";"       0";"       0";"       0";"       0";"       0";"       0";"       0";"       0"
"Eindhoven Airport";"2002 May";"    1261";"     185";"     476";"     410";"      66";"     482";"     412";"      70";"   19664";"   11956";"    7708";"   20489";"   12457";"    8032";"   40153";"   40153";"   27136";"   13017";"       0";"       0";"       0";"       0";"       0";"       0";"       0";"       0";"       0";"       0";"       0";"       0";"       0";"       0";"       0";"       0";"       0";"       0"
"Eindhoven Airport";"2002 June";"    1277";"     278";"     462";"     395";"      67";"     461";"     399";"      62";"   19515";"   11720";"    7795";"   18796";"   12464";"    6332";"   38311";"   38311";"   28299";"   10012";"       0";"       0";"       0";"       0";"       0";"       0";"       0";"       0";"       0";"       0";"       0";"       0";"       0";"       0";"       0";"       0";"       0";"       0"
"Eindhoven Airport";"2002 July";"    1220";"     244";"     477";"     424";"      53";"     480";"     426";"      54";"   16847";"   11375";"    5472";"   19871";"   12086";"    7785";"   36718";"   36718";"   24758";"   11960";"       0";"       0";"       0";"       0";"       0";"       0";"       0";"       0";"       0";"       0";"       0";"       0";"       0";"       0";"       0";"       0";"       0";"       0"
"Eindhoven Airport";"2002 August";"    1171";"     232";"     474";"     430";"      44";"     473";"     431";"      42";"   17087";"   11080";"    6007";"   16185";"   11508";"    4677";"   33272";"   33272";"   24538";"    8734";"       0";"       0";"       0";"       0";"       0";"       0";"       0";"       0";"       0";"       0";"       0";"       0";"       0";"       0";"       0";"       0";"       0";"       0"
"Eindhoven Airport";"2002 September";"    1339";"     240";"     502";"     423";"      79";"     499";"     423";"      76";"   20163";"   11986";"    8177";"   21882";"   13006";"    8876";"   42045";"   42045";"   30611";"   11434";"       0";"       0";"       0";"       0";"       0";"       0";"       0";"       0";"       0";"       0";"       0";"       0";"       0";"       0";"       0";"       0";"       0";"       0"
"Eindhoven Airport";"2002 October";"    1274";"     166";"     505";"     441";"      64";"     502";"     447";"      55";"   20804";"   12349";"    8455";"   19671";"   13296";"    6375";"   40475";"   40475";"   26450";"   14025";"       0";"       0";"       0";"       0";"       0";"       0";"       0";"       0";"       0";"       0";"       0";"       0";"       0";"       0";"       0";"       0";"       0";"       0"
"Eindhoven Airport";"2002 November";"    1103";"     126";"     442";"     412";"      30";"     443";"     415";"      28";"   13914";"   11280";"    2634";"   14430";"   12075";"    2355";"   28344";"   28344";"   23945";"    4399";"       0";"       0";"       0";"       0";"       0";"       0";"       0";"       0";"       0";"       0";"       0";"       0";"       0";"       0";"       0";"       0";"       0";"       0"
"Eindhoven Airport";"2002 December";"     906";"      59";"     350";"     336";"      14";"     354";"     339";"      15";"   11137";"   10160";"     977";"   11019";"   10241";"     778";"   22156";"   22156";"   20484";"    1672";"       0";"       0";"       0";"       0";"       0";"       0";"       0";"       0";"       0";"       0";"       0";"       0";"       0";"       0";"       0";"       0";"       0";"       0"
"Eindhoven Airport";"2003 January";"     985";"     104";"     392";"     368";"      24";"     393";"     369";"      24";"   10118";"    9181";"     937";"   11188";"   10203";"     985";"   21306";"   20973";"   19614";"    1359";"     333";"     333";"     333";"       0";"       0";"       0";"       0";"       0";"       0";"       0";"       0";"       0";"       0";"       0";"       0";"       0";"       0";"       0"
"Eindhoven Airport";"2003 February";"     973";"     135";"     381";"     354";"      27";"     383";"     355";"      28";"   11391";"   10042";"    1349";"   11919";"   10534";"    1385";"   23310";"   23310";"   20991";"    2319";"       0";"       0";"       0";"       0";"       0";"       0";"       0";"       0";"       0";"       0";"       0";"       0";"       0";"       0";"       0";"       0";"       0";"       0"
"Eindhoven Airport";"2003 March";"    1137";"     138";"     440";"     399";"      41";"     443";"     402";"      41";"   13222";"   10839";"    2383";"   13619";"   11204";"    2415";"   26841";"   26841";"   23132";"    3709";"       0";"       0";"       0";"       0";"       0";"       0";"       0";"       0";"       0";"       0";"       0";"       0";"       0";"       0";"       0";"       0";"       0";"       0"
"Eindhoven Airport";"2003 April";"    1111";"     124";"     430";"     378";"      52";"     431";"     380";"      51";"   13751";"   10633";"    3118";"   16273";"   11151";"    5122";"   30024";"   29802";"   22212";"    7590";"     222";"     222";"     222";"       0";"       0";"       0";"       0";"       0";"       0";"       0";"       0";"       0";"       0";"       0";"       0";"       0";"       0";"       0"
"Eindhoven Airport";"2003 May";"    1149";"     222";"     425";"     344";"      81";"     427";"     345";"      82";"   20700";"   11238";"    9462";"   21417";"   11514";"    9903";"   42117";"   42117";"   26515";"   15602";"       0";"       0";"       0";"       0";"       0";"       0";"       0";"       0";"       0";"       0";"       0";"       0";"       0";"       0";"       0";"       0";"       0";"       0"
"Eindhoven Airport";"2003 June";"    1152";"     226";"     428";"     343";"      85";"     424";"     343";"      81";"   20433";"   11007";"    9426";"   19861";"   11224";"    8637";"   40294";"   40294";"   25454";"   14840";"       0";"       0";"       0";"       0";"       0";"       0";"       0";"       0";"       0";"       0";"       0";"       0";"       0";"       0";"       0";"       0";"       0";"       0"
"Eindhoven Airport";"2003 July";"    1143";"     213";"     435";"     361";"      74";"     436";"     360";"      76";"   20427";"   11325";"    9102";"   24611";"   12183";"   12428";"   45038";"   44779";"   25170";"   19609";"     259";"       0";"       0";"       0";"       0";"       0";"       0";"     259";"     259";"       0";"       0";"       0";"       0";"       0";"       0";"       0";"       0";"       0"
"Eindhoven Airport";"2003 August";"    1086";"     197";"     407";"     338";"      69";"     403";"     336";"      67";"   23472";"   10161";"   13311";"   19643";"   10075";"    9568";"   43115";"   43115";"   21907";"   21208";"       0";"       0";"       0";"       0";"       0";"       0";"       0";"       0";"       0";"       0";"       0";"       0";"       0";"       0";"       0";"       0";"       0";"       0"
"Eindhoven Airport";"2003 September";"    1227";"     204";"     455";"     362";"      93";"     463";"     369";"      94";"   23078";"   11993";"   11085";"   25417";"   12902";"   12515";"   48495";"   48495";"   29470";"   19025";"       0";"       0";"       0";"       0";"       0";"       0";"       0";"       0";"       0";"       0";"       0";"       0";"       0";"       0";"       0";"       0";"       0";"       0"
"Eindhoven Airport";"2003 October";"    1177";"     102";"     451";"     373";"      78";"     440";"     370";"      70";"   23949";"   12415";"   11534";"   23169";"   13050";"   10119";"   47118";"   47118";"   27046";"   20072";"       0";"       0";"       0";"       0";"       0";"       0";"       0";"       0";"       0";"       0";"       0";"       0";"       0";"       0";"       0";"       0";"       0";"       0"
"Eindhoven Airport";"2003 November";"    1007";"     110";"     379";"     319";"      60";"     378";"     322";"      56";"   16967";"   10411";"    6556";"   16638";"   11606";"    5032";"   33605";"   33605";"   25183";"    8422";"       0";"       0";"       0";"       0";"       0";"       0";"       0";"       0";"       0";"       0";"       0";"       0";"       0";"       0";"       0";"       0";"       0";"       0"
"Eindhoven Airport";"2003 December";"     820";"      62";"     306";"     269";"      37";"     308";"     272";"      36";"   12924";"    9801";"    3123";"   13509";"   10516";"    2993";"   26433";"   26433";"   21852";"    4581";"       0";"       0";"       0";"       0";"       0";"       0";"       0";"       0";"       0";"       0";"       0";"       0";"       0";"       0";"       0";"       0";"       0";"       0"
"Eindhoven Airport";"2004 January";"     919";"      68";"     351";"     313";"      38";"     351";"     313";"      38";"   11549";"    8437";"    3112";"   11520";"    8968";"    2552";"   23069";"   22478";"   18845";"    3633";"     591";"     591";"       0";"     591";"       0";"       0";"       0";"       0";"       0";"       0";"       0";"       0";"       0";"       0";"       0";"       0";"       0";"       0"
"Eindhoven Airport";"2004 February";"    1071";"      66";"     399";"     341";"      58";"     400";"     344";"      56";"   16062";"   12010";"    4052";"   17448";"   13670";"    3778";"   33510";"   33510";"   28541";"    4969";"       0";"       0";"       0";"       0";"       0";"       0";"       0";"       0";"       0";"       0";"       0";"       0";"       0";"       0";"       0";"       0";"       0";"       0"
"Eindhoven Airport";"2004 March";"    1262";"     160";"     472";"     407";"      65";"     473";"     408";"      65";"   20597";"   16319";"    4278";"   21719";"   17073";"    4646";"   42316";"   42316";"   33091";"    9225";"       0";"       0";"       0";"       0";"       0";"       0";"       0";"       0";"       0";"       0";"       0";"       0";"       0";"       0";"       0";"       0";"       0";"       0"
"Eindhoven Airport";"2004 April";"    1217";"     128";"     458";"     383";"      75";"     464";"     382";"      82";"   24646";"   17434";"    7212";"   30922";"   19225";"   11697";"   55568";"   55568";"   31961";"   23607";"       0";"       0";"       0";"       0";"       0";"       0";"       0";"       0";"       0";"       0";"       0";"       0";"       0";"       0";"       0";"       0";"       0";"       0"
"Eindhoven Airport";"2004 May";"    1313";"     140";"     494";"     368";"     126";"     495";"     368";"     127";"   37759";"   18281";"   19478";"   37632";"   18344";"   19288";"   75391";"   75391";"   34752";"   40639";"       0";"       0";"       0";"       0";"       0";"       0";"       0";"       0";"       0";"       0";"       0";"       0";"       0";"       0";"       0";"       0";"       0";"       0"
"Eindhoven Airport";"2004 June";"    1212";"     186";"     463";"     363";"     100";"     462";"     363";"      99";"   30087";"   16337";"   13750";"   28200";"   18008";"   10192";"   58287";"   58287";"   31119";"   27168";"       0";"       0";"       0";"       0";"       0";"       0";"       0";"       0";"       0";"       0";"       0";"       0";"       0";"       0";"       0";"       0";"       0";"       0"
"Eindhoven Airport";"2004 July";"    1279";"     196";"     453";"     361";"      92";"     456";"     361";"      95";"   30295";"   18373";"   11922";"   37902";"   21564";"   16338";"   68197";"   68197";"   34613";"   33584";"       0";"       0";"       0";"       0";"       0";"       0";"       0";"       0";"       0";"       0";"       0";"       0";"       0";"       0";"       0";"       0";"       0";"       0"
"Eindhoven Airport";"2004 August";"    1198";"     154";"     442";"     335";"     107";"     444";"     337";"     107";"   40237";"   19471";"   20766";"   36090";"   18189";"   17901";"   76327";"   76327";"   33459";"   42868";"       0";"       0";"       0";"       0";"       0";"       0";"       0";"       0";"       0";"       0";"       0";"       0";"       0";"       0";"       0";"       0";"       0";"       0"
"Eindhoven Airport";"2004 September";"    1379";"     264";"     528";"     418";"     110";"     527";"     418";"     109";"   36954";"   22486";"   14468";"   36758";"   22534";"   14224";"   73712";"   73712";"   43491";"   30221";"       0";"       0";"       0";"       0";"       0";"       0";"       0";"       0";"       0";"       0";"       0";"       0";"       0";"       0";"       0";"       0";"       0";"       0"
"Eindhoven Airport";"2004 October";"    1417";"     154";"     549";"     429";"     120";"     548";"     430";"     118";"   45962";"   25980";"   19982";"   44635";"   26551";"   18084";"   90597";"   90597";"   47036";"   43561";"       0";"       0";"       0";"       0";"       0";"       0";"       0";"       0";"       0";"       0";"       0";"       0";"       0";"       0";"       0";"       0";"       0";"       0"
"Eindhoven Airport";"2004 November";"    1233";"      78";"     472";"     422";"      50";"     474";"     424";"      50";"   31748";"   24561";"    7187";"   30817";"   24909";"    5908";"   62565";"   62565";"   45133";"   17432";"       0";"       0";"       0";"       0";"       0";"       0";"       0";"       0";"       0";"       0";"       0";"       0";"       0";"       0";"       0";"       0";"       0";"       0"
"Eindhoven Airport";"2004 December";"    1026";"      48";"     379";"     345";"      34";"     379";"     346";"      33";"   22289";"   20140";"    2149";"   24641";"   21820";"    2821";"   46930";"   46807";"   39367";"    7440";"     123";"       0";"       0";"       0";"       0";"       0";"       0";"       0";"       0";"       0";"       0";"     123";"     123";"       0";"       0";"       0";"       0";"       0"
"Eindhoven Airport";"2005 January";"     827";"      84";"     302";"     265";"      37";"     303";"     268";"      35";"   21365";"   18198";"    3167";"   21090";"   18231";"    2859";"   42455";"   41744";"   34628";"    7116";"     711";"     711";"       0";"     711";"       0";"       0";"       0";"       0";"       0";"       0";"       0";"       0";"       0";"       0";"       0";"       0";"       0";"       0"
"Eindhoven Airport";"2005 February";"     838";"      78";"     297";"     262";"      35";"     299";"     263";"      36";"   21429";"   19283";"    2146";"   22934";"   20220";"    2714";"   44363";"   44363";"   36984";"    7379";"       0";"       0";"       0";"       0";"       0";"       0";"       0";"       0";"       0";"       0";"       0";"       0";"       0";"       0";"       0";"       0";"       0";"       0"
"Eindhoven Airport";"2005 March";"    1111";"     124";"     381";"     316";"      65";"     384";"     317";"      67";"   29079";"   25589";"    3490";"   31895";"   26844";"    5051";"   60974";"   60974";"   48049";"   12925";"       0";"       0";"       0";"       0";"       0";"       0";"       0";"       0";"       0";"       0";"       0";"       0";"       0";"       0";"       0";"       0";"       0";"       0"
"Eindhoven Airport";"2005 April";"    1181";"     102";"     427";"     348";"      79";"     436";"     349";"      87";"   34965";"   28183";"    6782";"   40577";"   30228";"   10349";"   75542";"   75542";"   55934";"   19608";"       0";"       0";"       0";"       0";"       0";"       0";"       0";"       0";"       0";"       0";"       0";"       0";"       0";"       0";"       0";"       0";"       0";"       0"
"Eindhoven Airport";"2005 May";"    1337";"     138";"     518";"     364";"     154";"     521";"     365";"     156";"   51268";"   33134";"   18134";"   53629";"   33665";"   19964";"  104897";"  104897";"   66126";"   38771";"       0";"       0";"       0";"       0";"       0";"       0";"       0";"       0";"       0";"       0";"       0";"       0";"       0";"       0";"       0";"       0";"       0";"       0"
"Eindhoven Airport";"2005 June";"    1434";"     182";"     554";"     407";"     147";"     549";"     406";"     143";"   47544";"   32929";"   14615";"   49726";"   35217";"   14509";"   97270";"   97270";"   66870";"   30400";"       0";"       0";"       0";"       0";"       0";"       0";"       0";"       0";"       0";"       0";"       0";"       0";"       0";"       0";"       0";"       0";"       0";"       0"
"Eindhoven Airport";"2005 July";"    1361";"     128";"     503";"     364";"     139";"     503";"     362";"     141";"   46317";"   31150";"   15167";"   59612";"   36457";"   23155";"  105929";"  105929";"   65248";"   40681";"       0";"       0";"       0";"       0";"       0";"       0";"       0";"       0";"       0";"       0";"       0";"       0";"       0";"       0";"       0";"       0";"       0";"       0"
"Eindhoven Airport";"2005 August";"    1343";"     140";"     528";"     384";"     144";"     529";"     381";"     148";"   57232";"   36033";"   21199";"   50478";"   32944";"   17534";"  107710";"  107605";"   68006";"   39599";"     105";"       0";"       0";"       0";"       0";"       0";"       0";"       0";"       0";"       0";"       0";"     105";"     105";"       0";"       0";"       0";"       0";"       0"
"Eindhoven Airport";"2005 September";"    1481";"      84";"     564";"     403";"     161";"     563";"     403";"     160";"   47477";"   32619";"   14858";"   50634";"   32219";"   18415";"   98111";"   98111";"   68419";"   29692";"       0";"       0";"       0";"       0";"       0";"       0";"       0";"       0";"       0";"       0";"       0";"       0";"       0";"       0";"       0";"       0";"       0";"       0"
"Eindhoven Airport";"2005 October";"    1384";"     101";"     535";"     400";"     135";"     525";"     402";"     123";"   50825";"   33317";"   17508";"   48439";"   33135";"   15304";"   99264";"   99264";"   64344";"   34920";"       0";"       0";"       0";"       0";"       0";"       0";"       0";"       0";"       0";"       0";"       0";"       0";"       0";"       0";"       0";"       0";"       0";"       0"
"Eindhoven Airport";"2005 November";"    1189";"      47";"     453";"     394";"      59";"     456";"     397";"      59";"   36565";"   31854";"    4711";"   36093";"   32107";"    3986";"   72658";"   72658";"   62344";"   10314";"       0";"       0";"       0";"       0";"       0";"       0";"       0";"       0";"       0";"       0";"       0";"       0";"       0";"       0";"       0";"       0";"       0";"       0"
"Eindhoven Airport";"2005 December";"    1049";"      35";"     381";"     329";"      52";"     385";"     334";"      51";"   30800";"   27852";"    2948";"   32861";"   29657";"    3204";"   63661";"   63661";"   57543";"    6118";"       0";"       0";"       0";"       0";"       0";"       0";"       0";"       0";"       0";"       0";"       0";"       0";"       0";"       0";"       0";"       0";"       0";"       0"
"Eindhoven Airport";"2006 January";"    1088";"      46";"     391";"     332";"      59";"     391";"     334";"      57";"   31112";"   27238";"    3874";"   30319";"   26657";"    3662";"   61431";"   60853";"   53825";"    7028";"     578";"     578";"       0";"     578";"       0";"       0";"       0";"       0";"       0";"       0";"       0";"       0";"       0";"       0";"       0";"       0";"       0";"       0"
"Eindhoven Airport";"2006 February";"     994";"      18";"     355";"     301";"      54";"     355";"     303";"      52";"   27641";"   24646";"    2995";"   30148";"   26630";"    3518";"   57789";"   57693";"   53857";"    3836";"       0";"       0";"       0";"       0";"       0";"       0";"       0";"       0";"       0";"       0";"       0";"       0";"       0";"       0";"       0";"       0";"       0";"      96"
"Eindhoven Airport";"2006 March";"    1182";"      56";"     417";"     352";"      65";"     422";"     353";"      69";"   34565";"   30604";"    3961";"   35976";"   31173";"    4803";"   70541";"   70541";"   64151";"    6390";"       0";"       0";"       0";"       0";"       0";"       0";"       0";"       0";"       0";"       0";"       0";"       0";"       0";"       0";"       0";"       0";"       0";"       0"
"Eindhoven Airport";"2006 April";"     903";"      60";"     352";"     301";"      51";"     358";"     301";"      57";"   32864";"   30964";"    1900";"   36733";"   32843";"    3890";"   69597";"   69597";"   68870";"     727";"       0";"       0";"       0";"       0";"       0";"       0";"       0";"       0";"       0";"       0";"       0";"       0";"       0";"       0";"       0";"       0";"       0";"       0"
"Eindhoven Airport";"2006 May";"    1539";"      27";"     587";"     362";"     225";"     598";"     373";"     225";"   67427";"   39899";"   27528";"   69584";"   40734";"   28850";"  137011";"  136965";"  107938";"   29027";"      46";"       0";"       0";"       0";"       0";"       0";"       0";"       0";"       0";"       0";"       0";"      46";"      46";"       0";"       0";"       0";"       0";"       0"
"Eindhoven Airport";"2006 June";"    1427";"      82";"     506";"     335";"     171";"     542";"     375";"     167";"   53962";"   37829";"   16133";"   55597";"   38820";"   16777";"  109559";"  109559";"   88205";"   21354";"       0";"       0";"       0";"       0";"       0";"       0";"       0";"       0";"       0";"       0";"       0";"       0";"       0";"       0";"       0";"       0";"       0";"       0"
"Eindhoven Airport";"2006 July";"    1371";"      30";"     485";"     327";"     158";"     529";"     369";"     160";"   54514";"   36694";"   17820";"   67489";"   42308";"   25181";"  122003";"  122003";"   86368";"   35635";"       0";"       0";"       0";"       0";"       0";"       0";"       0";"       0";"       0";"       0";"       0";"       0";"       0";"       0";"       0";"       0";"       0";"       0"
"Eindhoven Airport";"2006 August";"    1355";"      12";"     509";"     347";"     162";"     551";"     389";"     162";"   62990";"   41380";"   21610";"   55642";"   37251";"   18391";"  118632";"  118632";"   86399";"   32233";"       0";"       0";"       0";"       0";"       0";"       0";"       0";"       0";"       0";"       0";"       0";"       0";"       0";"       0";"       0";"       0";"       0";"       0"
"Eindhoven Airport";"2006 September";"    1495";"      34";"     515";"     349";"     166";"     563";"     392";"     171";"   56124";"   38235";"   17889";"   60122";"   38756";"   21366";"  116246";"  116150";"   90469";"   25681";"      96";"       0";"       0";"       0";"       0";"       0";"       0";"      96";"      96";"       0";"       0";"       0";"       0";"       0";"       0";"       0";"       0";"       0"
"Eindhoven Airport";"2006 October";"    1470";"      69";"     522";"     371";"     151";"     550";"     414";"     136";"   59296";"   42560";"   16736";"   56991";"   42411";"   14580";"  116287";"  116287";"   89012";"   27275";"       0";"       0";"       0";"       0";"       0";"       0";"       0";"       0";"       0";"       0";"       0";"       0";"       0";"       0";"       0";"       0";"       0";"       0"
"Eindhoven Airport";"2006 November";"    1381";"      36";"     489";"     417";"      72";"     535";"     462";"      73";"   50562";"   45339";"    5223";"   48102";"   43737";"    4365";"   98664";"   98664";"   94131";"    4533";"       0";"       0";"       0";"       0";"       0";"       0";"       0";"       0";"       0";"       0";"       0";"       0";"       0";"       0";"       0";"       0";"       0";"       0"
"Eindhoven Airport";"2006 December";"    1158";"      10";"     424";"     375";"      49";"     452";"     403";"      49";"   44203";"   41398";"    2805";"   48558";"   45342";"    3216";"   92761";"   92761";"   91003";"    1758";"       0";"       0";"       0";"       0";"       0";"       0";"       0";"       0";"       0";"       0";"       0";"       0";"       0";"       0";"       0";"       0";"       0";"       0"
"Eindhoven Airport";"2007 January";"    1228";"       2";"     441";"     391";"      50";"     478";"     433";"      45";"   44875";"   41086";"    3789";"   43524";"   40157";"    3367";"   88399";"   87736";"   86289";"    1447";"     663";"     663";"       0";"     663";"       0";"       0";"       0";"       0";"       0";"       0";"       0";"       0";"       0";"       0";"       0";"       0";"       0";"       0"
"Eindhoven Airport";"2007 February";"    1217";"      22";"     409";"     360";"      49";"     452";"     401";"      51";"   41241";"   38891";"    2350";"   44995";"   41760";"    3235";"   86236";"   86236";"   85739";"     497";"       0";"       0";"       0";"       0";"       0";"       0";"       0";"       0";"       0";"       0";"       0";"       0";"       0";"       0";"       0";"       0";"       0";"       0"
"Eindhoven Airport";"2007 March";"    1580";"      27";"     505";"     432";"      73";"     551";"     475";"      76";"   52928";"   49133";"    3795";"   55559";"   49744";"    5815";"  108487";"  108487";"  106072";"    2415";"       0";"       0";"       0";"       0";"       0";"       0";"       0";"       0";"       0";"       0";"       0";"       0";"       0";"       0";"       0";"       0";"       0";"       0"
"Eindhoven Airport";"2007 April";"    1470";"      40";"     491";"     395";"      96";"     529";"     434";"      95";"   56346";"   49503";"    6843";"   63634";"   52764";"   10870";"  119980";"  119980";"  109566";"   10414";"       0";"       0";"       0";"       0";"       0";"       0";"       0";"       0";"       0";"       0";"       0";"       0";"       0";"       0";"       0";"       0";"       0";"       0"
"Eindhoven Airport";"2007 May";"    1225";"      28";"     457";"     328";"     129";"     500";"     371";"     129";"   63785";"   48116";"   15669";"   65136";"   49699";"   15437";"  128921";"  128921";"  128436";"     485";"       0";"       0";"       0";"       0";"       0";"       0";"       0";"       0";"       0";"       0";"       0";"       0";"       0";"       0";"       0";"       0";"       0";"       0"
"Eindhoven Airport";"2007 June";"    1581";"      21";"     602";"     451";"     151";"     643";"     495";"     148";"   72893";"   56791";"   16102";"   75068";"   57685";"   17383";"  147961";"  147961";"  131238";"   16723";"       0";"       0";"       0";"       0";"       0";"       0";"       0";"       0";"       0";"       0";"       0";"       0";"       0";"       0";"       0";"       0";"       0";"       0"
"Eindhoven Airport";"2007 July";"    1000";"      24";"     368";"     346";"      22";"     413";"     390";"      23";"   50963";"   50194";"     769";"   56887";"   55804";"    1083";"  107850";"  107850";"  105519";"    2331";"       0";"       0";"       0";"       0";"       0";"       0";"       0";"       0";"       0";"       0";"       0";"       0";"       0";"       0";"       0";"       0";"       0";"       0"
"Eindhoven Airport";"2007 August";"    1554";"      34";"     578";"     441";"     137";"     622";"     483";"     139";"   84818";"   64688";"   20130";"   75323";"   58281";"   17042";"  160141";"  160141";"  138772";"   21369";"       0";"       0";"       0";"       0";"       0";"       0";"       0";"       0";"       0";"       0";"       0";"       0";"       0";"       0";"       0";"       0";"       0";"       0"
"Eindhoven Airport";"2007 September";"    1652";"      32";"     594";"     451";"     143";"     633";"     490";"     143";"   72523";"   55029";"   17494";"   76464";"   56979";"   19485";"  148987";"  148987";"  133331";"   15656";"       0";"       0";"       0";"       0";"       0";"       0";"       0";"       0";"       0";"       0";"       0";"       0";"       0";"       0";"       0";"       0";"       0";"       0"
"Eindhoven Airport";"2007 October";"    1786";"      10";"     649";"     496";"     153";"     688";"     545";"     143";"   77212";"   58396";"   18816";"   72310";"   57794";"   14516";"  149522";"  149522";"  131681";"   17841";"       0";"       0";"       0";"       0";"       0";"       0";"       0";"       0";"       0";"       0";"       0";"       0";"       0";"       0";"       0";"       0";"       0";"       0"
"Eindhoven Airport";"2007 November";"     774";"       0";"     350";"     339";"      11";"     371";"     360";"      11";"   43887";"   43822";"      65";"   44702";"   44646";"      56";"   88589";"   88589";"   88589";"       0";"       0";"       0";"       0";"       0";"       0";"       0";"       0";"       0";"       0";"       0";"       0";"       0";"       0";"       0";"       0";"       0";"       0";"       0"
"Eindhoven Airport";"2007 December";"    1383";"      14";"     518";"     465";"      53";"     548";"     497";"      51";"   51888";"   48905";"    2983";"   55615";"   52441";"    3174";"  107503";"  106871";"  105875";"     996";"     632";"     632";"     632";"       0";"       0";"       0";"       0";"       0";"       0";"       0";"       0";"       0";"       0";"       0";"       0";"       0";"       0";"       0"
"Eindhoven Airport";"2008 January";"    1360";"       6";"     535";"     485";"      50";"     561";"     509";"      52";"   51183";"   47919";"    3264";"   50961";"   47370";"    3591";"  102144";"  101064";"  100249";"     815";"    1080";"    1080";"    1080";"       0";"       0";"       0";"       0";"       0";"       0";"       0";"       0";"       0";"       0";"       0";"       0";"       0";"       0";"       0"
"Eindhoven Airport";"2008 February";"    1392";"      20";"     542";"     489";"      53";"     560";"     509";"      51";"   52606";"   49142";"    3464";"   55289";"   51323";"    3966";"  107895";"  106573";"  105729";"     844";"    1321";"    1321";"    1321";"       0";"       0";"       0";"       0";"       0";"       0";"       0";"       0";"       0";"       0";"       0";"       0";"       0";"       0";"       1"
"Eindhoven Airport";"2008 March";"    1517";"      76";"     583";"     519";"      64";"     604";"     541";"      63";"   62144";"   57075";"    5069";"   64128";"   58171";"    5957";"  126272";"  125041";"  122626";"    2415";"    1231";"    1231";"    1231";"       0";"       0";"       0";"       0";"       0";"       0";"       0";"       0";"       0";"       0";"       0";"       0";"       0";"       0";"       0"
"Eindhoven Airport";"2008 April";"    1546";"      14";"     610";"     533";"      77";"     618";"     536";"      82";"   59862";"   55067";"    4795";"   70342";"   60416";"    9926";"  130204";"  130204";"  123315";"    6889";"       0";"       0";"       0";"       0";"       0";"       0";"       0";"       0";"       0";"       0";"       0";"       0";"       0";"       0";"       0";"       0";"       0";"       0"
"Eindhoven Airport";"2008 May";"    1692";"      26";"     675";"     516";"     159";"     675";"     517";"     158";"   83522";"   64595";"   18927";"   84626";"   63352";"   21274";"  168148";"  168026";"  149698";"   18328";"     122";"       0";"       0";"       0";"       0";"       0";"       0";"       0";"       0";"       0";"       0";"     122";"     122";"       0";"       0";"       0";"       0";"       0"
"Eindhoven Airport";"2008 June";"    1739";"      11";"     687";"     536";"     151";"     683";"     536";"     147";"   78509";"   61328";"   17181";"   81009";"   62402";"   18607";"  159518";"  159518";"  142129";"   17389";"       0";"       0";"       0";"       0";"       0";"       0";"       0";"       0";"       0";"       0";"       0";"       0";"       0";"       0";"       0";"       0";"       0";"       0"
"Eindhoven Airport";"2008 July";"    1741";"      20";"     689";"     533";"     156";"     691";"     533";"     158";"   81335";"   62312";"   19023";"   94973";"   69604";"   25369";"  176308";"  176308";"  152171";"   24137";"       0";"       0";"       0";"       0";"       0";"       0";"       0";"       0";"       0";"       0";"       0";"       0";"       0";"       0";"       0";"       0";"       0";"       0"
"Eindhoven Airport";"2008 August";"    1521";"      10";"     627";"     495";"     132";"     632";"     495";"     137";"   89540";"   68914";"   20626";"   79682";"   61602";"   18080";"  169222";"  169222";"  149869";"   19353";"       0";"       0";"       0";"       0";"       0";"       0";"       0";"       0";"       0";"       0";"       0";"       0";"       0";"       0";"       0";"       0";"       0";"       0"
"Eindhoven Airport";"2008 September";"    1699";"      38";"     675";"     529";"     146";"     677";"     529";"     148";"   76427";"   58310";"   18117";"   82464";"   60442";"   22022";"  158891";"  158465";"  141285";"   17180";"     426";"       0";"       0";"       0";"       0";"       0";"       0";"       0";"       0";"       0";"       0";"     426";"     426";"       0";"       0";"       0";"       0";"       0"
"Eindhoven Airport";"2008 October";"    1678";"      18";"     686";"     553";"     133";"     681";"     553";"     128";"   83853";"   65806";"   18047";"   78277";"   63300";"   14977";"  162130";"  161720";"  144848";"   16872";"     410";"       0";"       0";"       0";"       0";"       0";"       0";"       0";"       0";"       0";"       0";"     410";"     410";"       0";"       0";"       0";"       0";"       0"
"Eindhoven Airport";"2008 November";"    1149";"       4";"     465";"     432";"      33";"     464";"     435";"      29";"   53496";"   50393";"    3103";"   52827";"   49905";"    2922";"  106323";"  106012";"  104621";"    1391";"     311";"       0";"       0";"       0";"       0";"       0";"       0";"       0";"       0";"       0";"       0";"     311";"     311";"       0";"       0";"       0";"       0";"       0"
"Eindhoven Airport";"2008 December";"    1081";"       2";"     433";"     414";"      19";"     438";"     417";"      21";"   47347";"   46289";"    1058";"   52015";"   49803";"    2212";"   99362";"   99362";"   99362";"       0";"       0";"       0";"       0";"       0";"       0";"       0";"       0";"       0";"       0";"       0";"       0";"       0";"       0";"       0";"       0";"       0";"       0";"       0"
"Eindhoven Airport";"2009 January";"    1013";"      12";"     428";"     403";"      25";"     427";"     402";"      25";"   44505";"   43200";"    1305";"   45988";"   43187";"    2801";"   90493";"   90493";"   90377";"     116";"       0";"       0";"       0";"       0";"       0";"       0";"       0";"       0";"       0";"       0";"       0";"       0";"       0";"       0";"       0";"       0";"       0";"       0"
"Eindhoven Airport";"2009 February";"    1054";"       0";"     413";"     389";"      24";"     415";"     389";"      26";"   47727";"   46364";"    1363";"   51646";"   49033";"    2613";"   99373";"   99373";"   98840";"     533";"       0";"       0";"       0";"       0";"       0";"       0";"       0";"       0";"       0";"       0";"       0";"       0";"       0";"       0";"       0";"       0";"       0";"       0"
"Eindhoven Airport";"2009 March";"    1187";"      16";"     468";"     439";"      29";"     468";"     439";"      29";"   55991";"   54090";"    1901";"   56737";"   53410";"    3327";"  112728";"  112728";"  111427";"    1301";"       0";"       0";"       0";"       0";"       0";"       0";"       0";"       0";"       0";"       0";"       0";"       0";"       0";"       0";"       0";"       0";"       0";"       0"
"Eindhoven Airport";"2009 April";"    1204";"       7";"     498";"     453";"      45";"     508";"     454";"      54";"   59593";"   56754";"    2839";"   69979";"   61675";"    8304";"  129572";"  129572";"  121344";"    8228";"       0";"       0";"       0";"       0";"       0";"       0";"       0";"       0";"       0";"       0";"       0";"       0";"       0";"       0";"       0";"       0";"       0";"       0"
"Eindhoven Airport";"2009 May";"    1409";"      18";"     587";"     461";"     126";"     584";"     461";"     123";"   77668";"   62050";"   15618";"   78779";"   61621";"   17158";"  156447";"  156447";"  138028";"   18419";"       0";"       0";"       0";"       0";"       0";"       0";"       0";"       0";"       0";"       0";"       0";"       0";"       0";"       0";"       0";"       0";"       0";"       0"
"Eindhoven Airport";"2009 June";"    1447";"      12";"     589";"     479";"     110";"     588";"     479";"     109";"   76607";"   63270";"   13337";"   78406";"   63412";"   14994";"  155013";"  154770";"  140282";"   14488";"     243";"       0";"       0";"       0";"       0";"       0";"       0";"       0";"       0";"       0";"       0";"     243";"     243";"       0";"       0";"       0";"       0";"       0"
"Eindhoven Airport";"2009 July";"    1541";"      20";"     651";"     519";"     132";"     650";"     518";"     132";"   82130";"   67163";"   14967";"   98796";"   77466";"   21330";"  180926";"  180319";"  161898";"   18421";"     607";"       0";"       0";"       0";"       0";"       0";"       0";"     189";"     189";"       0";"       0";"     418";"     418";"       0";"       0";"       0";"       0";"       0"
"Eindhoven Airport";"2009 August";"    1477";"      12";"     652";"     516";"     136";"     651";"     516";"     135";"   99087";"   77907";"   21180";"   91976";"   72201";"   19775";"  191063";"  190994";"  168379";"   22615";"      69";"       0";"       0";"       0";"       0";"       0";"       0";"       0";"       0";"       0";"       0";"      69";"      69";"       0";"       0";"       0";"       0";"       0"
"Eindhoven Airport";"2009 September";"    1582";"      43";"     667";"     529";"     138";"     666";"     530";"     136";"   89217";"   71678";"   17539";"   90528";"   71294";"   19234";"  179745";"  179693";"  160579";"   19114";"      52";"      52";"      52";"       0";"       0";"       0";"       0";"       0";"       0";"       0";"       0";"       0";"       0";"       0";"       0";"       0";"       0";"       0"
"Eindhoven Airport";"2009 October";"    1554";"      10";"     654";"     552";"     102";"     647";"     552";"      95";"   89713";"   75872";"   13841";"   85883";"   74668";"   11215";"  175596";"  175596";"  154631";"   20965";"       0";"       0";"       0";"       0";"       0";"       0";"       0";"       0";"       0";"       0";"       0";"       0";"       0";"       0";"       0";"       0";"       0";"       0"
"Eindhoven Airport";"2009 November";"    1350";"      14";"     569";"     555";"      14";"     567";"     554";"      13";"   71533";"   70412";"    1121";"   67789";"   66657";"    1132";"  139322";"  139322";"  135302";"    4020";"       0";"       0";"       0";"       0";"       0";"       0";"       0";"       0";"       0";"       0";"       0";"       0";"       0";"       0";"       0";"       0";"       0";"       0"
"Eindhoven Airport";"2009 December";"    1302";"       8";"     541";"     527";"      14";"     544";"     528";"      16";"   62024";"   60809";"    1215";"   66751";"   65461";"    1290";"  128775";"  128775";"  126188";"    2587";"       0";"       0";"       0";"       0";"       0";"       0";"       0";"       0";"       0";"       0";"       0";"       0";"       0";"       0";"       0";"       0";"       0";"       0"
"Eindhoven Airport";"2010 January";"    1272";"       2";"     541";"     525";"      16";"     536";"     526";"      10";"   55915";"   54319";"    1596";"   55481";"   54538";"     943";"  111396";"  111231";"  109174";"    2057";"     165";"     165";"     165";"       0";"       0";"       0";"       0";"       0";"       0";"       0";"       0";"       0";"       0";"       0";"       0";"       0";"       0";"       0"
"Eindhoven Airport";"2010 February";"    1275";"       2";"     531";"     515";"      16";"     533";"     517";"      16";"   59362";"   57899";"    1463";"   62971";"   61585";"    1386";"  122333";"  122333";"  120059";"    2274";"       0";"       0";"       0";"       0";"       0";"       0";"       0";"       0";"       0";"       0";"       0";"       0";"       0";"       0";"       0";"       0";"       0";"       0"
"Eindhoven Airport";"2010 March";"    1429";"      10";"     589";"     579";"      10";"     591";"     580";"      11";"   72779";"   71642";"    1137";"   73402";"   72358";"    1044";"  146181";"  146181";"  142760";"    3421";"       0";"       0";"       0";"       0";"       0";"       0";"       0";"       0";"       0";"       0";"       0";"       0";"       0";"       0";"       0";"       0";"       0";"       0"
"Eindhoven Airport";"2010 April";"    1316";"      10";"     543";"     510";"      33";"     547";"     510";"      37";"   63317";"   61378";"    1939";"   74778";"   70067";"    4711";"  138095";"  138095";"  128347";"    9748";"       0";"       0";"       0";"       0";"       0";"       0";"       0";"       0";"       0";"       0";"       0";"       0";"       0";"       0";"       0";"       0";"       0";"       0"
"Eindhoven Airport";"2010 May";"    1825";"      12";"     782";"     645";"     137";"     776";"     644";"     132";"  104568";"   89649";"   14919";"  110664";"   92163";"   18501";"  215232";"  215232";"  189129";"   26103";"       0";"       0";"       0";"       0";"       0";"       0";"       0";"       0";"       0";"       0";"       0";"       0";"       0";"       0";"       0";"       0";"       0";"       0"
"Eindhoven Airport";"2010 June";"    1760";"       8";"     746";"     638";"     108";"     747";"     639";"     108";"  100731";"   87160";"   13571";"  103080";"   89224";"   13856";"  203811";"  203811";"  185719";"   18092";"       0";"       0";"       0";"       0";"       0";"       0";"       0";"       0";"       0";"       0";"       0";"       0";"       0";"       0";"       0";"       0";"       0";"       0"
"Eindhoven Airport";"2010 July";"    1918";"      22";"     813";"     692";"     121";"     816";"     694";"     122";"  106546";"   93564";"   12982";"  127974";"  109747";"   18227";"  234520";"  234520";"  210452";"   24068";"       0";"       0";"       0";"       0";"       0";"       0";"       0";"       0";"       0";"       0";"       0";"       0";"       0";"       0";"       0";"       0";"       0";"       0"
"Eindhoven Airport";"2010 August";"    1982";"      14";"     861";"     725";"     136";"     860";"     724";"     136";"  134554";"  113532";"   21022";"  123626";"  104775";"   18851";"  258180";"  258180";"  229595";"   28585";"       0";"       0";"       0";"       0";"       0";"       0";"       0";"       0";"       0";"       0";"       0";"       0";"       0";"       0";"       0";"       0";"       0";"       0"
"Eindhoven Airport";"2010 September";"    1962";"      12";"     801";"     668";"     133";"     801";"     666";"     135";"  113923";"   96139";"   17784";"  114027";"   95969";"   18058";"  227950";"  227905";"  207333";"   20572";"       0";"       0";"       0";"       0";"       0";"       0";"       0";"       0";"       0";"       0";"       0";"       0";"       0";"       0";"       0";"       0";"       0";"      45"
"Eindhoven Airport";"2010 October";"    1821";"      11";"     780";"     679";"     101";"     777";"     680";"      97";"  113795";"   99992";"   13803";"  111274";"   99340";"   11934";"  225069";"  225069";"  198851";"   26218";"       0";"       0";"       0";"       0";"       0";"       0";"       0";"       0";"       0";"       0";"       0";"       0";"       0";"       0";"       0";"       0";"       0";"       0"
"Eindhoven Airport";"2010 November";"    1397";"      16";"     569";"     545";"      24";"     571";"     546";"      25";"   77796";"   75530";"    2266";"   74572";"   71643";"    2929";"  152368";"  152368";"  147708";"    4660";"       0";"       0";"       0";"       0";"       0";"       0";"       0";"       0";"       0";"       0";"       0";"       0";"       0";"       0";"       0";"       0";"       0";"       0"
"Eindhoven Airport";"2010 December";"    1407";"       3";"     568";"     530";"      38";"     565";"     537";"      28";"   70239";"   67147";"    3092";"   77409";"   74520";"    2889";"  147648";"  147408";"  144655";"    2753";"     240";"       0";"       0";"       0";"       0";"       0";"       0";"     240";"     240";"       0";"       0";"       0";"       0";"       0";"       0";"       0";"       0";"       0"
"Eindhoven Airport";"2011 January";"    1443";"       0";"     616";"     596";"      20";"     616";"     596";"      20";"   71925";"   70534";"    1391";"   70959";"   69368";"    1591";"  142884";"  142884";"  140193";"    2691";"       0";"       0";"       0";"       0";"       0";"       0";"       0";"       0";"       0";"       0";"       0";"       0";"       0";"       0";"       0";"       0";"       0";"       0"
"Eindhoven Airport";"2011 February";"    1273";"       1";"     539";"     521";"      18";"     540";"     522";"      18";"   64665";"   63187";"    1478";"   68993";"   67651";"    1342";"  133658";"  133658";"  131505";"    2153";"       0";"       0";"       0";"       0";"       0";"       0";"       0";"       0";"       0";"       0";"       0";"       0";"       0";"       0";"       0";"       0";"       0";"       0"
"Eindhoven Airport";"2011 March";"    1558";"       0";"     628";"     605";"      23";"     630";"     605";"      25";"   82993";"   80857";"    2136";"   84757";"   82482";"    2275";"  167750";"  167750";"  163387";"    4363";"       0";"       0";"       0";"       0";"       0";"       0";"       0";"       0";"       0";"       0";"       0";"       0";"       0";"       0";"       0";"       0";"       0";"       0"
"Eindhoven Airport";"2011 April";"    1919";"       0";"     819";"     767";"      52";"     823";"     769";"      54";"  106805";"  103248";"    3557";"  122039";"  115533";"    6506";"  228844";"  228844";"  210496";"   18348";"       0";"       0";"       0";"       0";"       0";"       0";"       0";"       0";"       0";"       0";"       0";"       0";"       0";"       0";"       0";"       0";"       0";"       0"
"Eindhoven Airport";"2011 May";"    2368";"       0";"    1022";"     881";"     141";"    1015";"     873";"     142";"  137585";"  124386";"   13199";"  138216";"  123896";"   14320";"  275801";"  275801";"  242133";"   33668";"       0";"       0";"       0";"       0";"       0";"       0";"       0";"       0";"       0";"       0";"       0";"       0";"       0";"       0";"       0";"       0";"       0";"       0"
"Eindhoven Airport";"2011 June";"    2170";"       0";"     960";"     828";"     132";"     959";"     832";"     127";"  128878";"  116778";"   12100";"  128265";"  116935";"   11330";"  257143";"  256933";"  234519";"   22414";"     183";"     183";"     183";"       0";"       0";"       0";"       0";"       0";"       0";"       0";"       0";"       0";"       0";"       0";"       0";"       0";"       0";"      27"
"Eindhoven Airport";"2011 July";"    2288";"       0";"    1012";"     872";"     140";"    1010";"     873";"     137";"  133189";"  119847";"   13342";"  159669";"  143073";"   16596";"  292858";"  291720";"  258886";"   32834";"    1138";"    1138";"    1138";"       0";"       0";"       0";"       0";"       0";"       0";"       0";"       0";"       0";"       0";"       0";"       0";"       0";"       0";"       0"
"Eindhoven Airport";"2011 August";"    2278";"       0";"    1019";"     884";"     135";"    1018";"     881";"     137";"  157254";"  141177";"   16077";"  139275";"  125593";"   13682";"  296529";"  296010";"  262386";"   33624";"     519";"     519";"     519";"       0";"       0";"       0";"       0";"       0";"       0";"       0";"       0";"       0";"       0";"       0";"       0";"       0";"       0";"       0"
"Eindhoven Airport";"2011 September";"    2235";"       8";"     971";"     833";"     138";"     967";"     831";"     136";"  136022";"  122044";"   13978";"  135289";"  121369";"   13920";"  271311";"  271311";"  243517";"   27794";"       0";"       0";"       0";"       0";"       0";"       0";"       0";"       0";"       0";"       0";"       0";"       0";"       0";"       0";"       0";"       0";"       0";"       0"
"Eindhoven Airport";"2011 October";"    2125";"       6";"     946";"     855";"      91";"     946";"     856";"      90";"  135084";"  124511";"   10573";"  128934";"  120199";"    8735";"  264018";"  263461";"  233855";"   29606";"     557";"     365";"     365";"       0";"       0";"       0";"       0";"       0";"       0";"       0";"       0";"     192";"     192";"       0";"       0";"       0";"       0";"       0"
"Eindhoven Airport";"2011 November";"    1399";"       0";"     631";"     609";"      22";"     629";"     612";"      17";"   84722";"   82694";"    2028";"   77339";"   76125";"    1214";"  162061";"  159768";"  153548";"    6220";"    2293";"    2293";"    2293";"       0";"       0";"       0";"       0";"       0";"       0";"       0";"       0";"       0";"       0";"       0";"       0";"       0";"       0";"       0"
"Eindhoven Airport";"2011 December";"    1494";"       0";"     682";"     660";"      22";"     682";"     661";"      21";"   80956";"   79644";"    1312";"   90265";"   88992";"    1273";"  171221";"  168667";"  165272";"    3395";"    2554";"    2554";"    2554";"       0";"       0";"       0";"       0";"       0";"       0";"       0";"       0";"       0";"       0";"       0";"       0";"       0";"       0";"       0"
"Eindhoven Airport";"2012 January";"    1653";"       0";"     739";"     720";"      19";"     741";"     723";"      18";"   87815";"   86653";"    1162";"   80941";"   79630";"    1311";"  168756";"  165981";"  161957";"    4024";"    2775";"    2775";"    2775";"       0";"       0";"       0";"       0";"       0";"       0";"       0";"       0";"       0";"       0";"       0";"       0";"       0";"       0";"       0"
"Eindhoven Airport";"2012 February";"    1591";"       0";"     697";"     673";"      24";"     699";"     675";"      24";"   81908";"   80324";"    1584";"   87859";"   86455";"    1404";"  169767";"  167127";"  161993";"    5134";"    2640";"    2640";"    2640";"       0";"       0";"       0";"       0";"       0";"       0";"       0";"       0";"       0";"       0";"       0";"       0";"       0";"       0";"       0"
"Eindhoven Airport";"2012 March";"    1834";"       0";"     809";"     787";"      22";"     814";"     791";"      23";"  101753";"  100346";"    1407";"  101677";"  100070";"    1607";"  203430";"  200295";"  193859";"    6436";"    3135";"    3135";"    3135";"       0";"       0";"       0";"       0";"       0";"       0";"       0";"       0";"       0";"       0";"       0";"       0";"       0";"       0";"       0"
"Eindhoven Airport";"2012 April";"    2138";"       0";"     961";"     899";"      62";"     964";"     903";"      61";"  123273";"  120387";"    2886";"  136590";"  129923";"    6667";"  259863";"  256629";"  238107";"   18522";"    3234";"    3234";"    3234";"       0";"       0";"       0";"       0";"       0";"       0";"       0";"       0";"       0";"       0";"       0";"       0";"       0";"       0";"       0"
"Eindhoven Airport";"2012 May";"    2476";"       0";"    1118";"     983";"     135";"    1121";"     987";"     134";"  150208";"  137423";"   12785";"  151746";"  139231";"   12515";"  301954";"  298751";"  264420";"   34331";"    3203";"    3203";"    3203";"       0";"       0";"       0";"       0";"       0";"       0";"       0";"       0";"       0";"       0";"       0";"       0";"       0";"       0";"       0"
"Eindhoven Airport";"2012 June";"    2380";"       0";"    1076";"     951";"     125";"    1077";"     953";"     124";"  142280";"  131804";"   10476";"  146457";"  135606";"   10851";"  288737";"  286079";"  257313";"   28766";"    2658";"    2658";"    2658";"       0";"       0";"       0";"       0";"       0";"       0";"       0";"       0";"       0";"       0";"       0";"       0";"       0";"       0";"       0"
"Eindhoven Airport";"2012 July";"    2534";"       0";"    1151";"    1012";"     139";"    1151";"    1011";"     140";"  155414";"  140872";"   14542";"  179547";"  162087";"   17460";"  334961";"  331895";"  294154";"   37741";"    3066";"    3066";"    3066";"       0";"       0";"       0";"       0";"       0";"       0";"       0";"       0";"       0";"       0";"       0";"       0";"       0";"       0";"       0"
"Eindhoven Airport";"2012 August";"    2417";"       0";"    1125";"     992";"     133";"    1124";"     992";"     132";"  172025";"  158268";"   13757";"  153342";"  142085";"   11257";"  325367";"  322338";"  288168";"   34170";"    3029";"    3029";"    3029";"       0";"       0";"       0";"       0";"       0";"       0";"       0";"       0";"       0";"       0";"       0";"       0";"       0";"       0";"       0"
"Eindhoven Airport";"2012 September";"    2312";"       0";"    1069";"     932";"     137";"    1072";"     935";"     137";"  146998";"  133456";"   13542";"  145552";"  131730";"   13822";"  292550";"  289452";"  258757";"   30695";"    3098";"    3098";"    3098";"       0";"       0";"       0";"       0";"       0";"       0";"       0";"       0";"       0";"       0";"       0";"       0";"       0";"       0";"       0"
"Eindhoven Airport";"2012 October";"    2280";"       0";"    1061";"     957";"     104";"    1058";"     958";"     100";"  148839";"  137608";"   11231";"  139503";"  130890";"    8613";"  288342";"  285523";"  251754";"   33769";"    2819";"    2819";"    2819";"       0";"       0";"       0";"       0";"       0";"       0";"       0";"       0";"       0";"       0";"       0";"       0";"       0";"       0";"       0"
"Eindhoven Airport";"2012 November";"    1526";"       0";"     706";"     687";"      19";"     707";"     688";"      19";"   96071";"   94433";"    1638";"   88644";"   87094";"    1550";"  184715";"  182136";"  171313";"   10823";"    2579";"    2579";"    2579";"       0";"       0";"       0";"       0";"       0";"       0";"       0";"       0";"       0";"       0";"       0";"       0";"       0";"       0";"       0"
"Eindhoven Airport";"2012 December";"    1495";"       0";"     703";"     687";"      16";"     707";"     691";"      16";"   87621";"   86297";"    1324";"   98875";"   97541";"    1334";"  186496";"  184046";"  177056";"    6990";"    2450";"    2450";"    2450";"       0";"       0";"       0";"       0";"       0";"       0";"       0";"       0";"       0";"       0";"       0";"       0";"       0";"       0";"       0"
"Eindhoven Airport";"2013 January";"    1760";"       0";"     797";"     776";"      21";"     799";"     777";"      22";"   93064";"   91739";"    1325";"   84490";"   83014";"    1476";"  177554";"  174984";"  166171";"    8813";"    2570";"    2570";"    2570";"       0";"       0";"       0";"       0";"       0";"       0";"       0";"       0";"       0";"       0";"       0";"       0";"       0";"       0";"       0"
"Eindhoven Airport";"2013 February";"    1608";"       0";"     739";"     723";"      16";"     738";"     722";"      16";"   90848";"   89620";"    1228";"   94297";"   93197";"    1100";"  185145";"  182398";"  173520";"    8878";"    2747";"    2747";"    2747";"       0";"       0";"       0";"       0";"       0";"       0";"       0";"       0";"       0";"       0";"       0";"       0";"       0";"       0";"       0"
"Eindhoven Airport";"2013 March";"    1984";"       0";"     919";"     900";"      19";"     921";"     902";"      19";"  115188";"  113968";"    1220";"  119030";"  117561";"    1469";"  234218";"  230808";"  220155";"   10653";"    3410";"    3410";"    3410";"       0";"       0";"       0";"       0";"       0";"       0";"       0";"       0";"       0";"       0";"       0";"       0";"       0";"       0";"       0"
"Eindhoven Airport";"2013 April";"    2234";"       0";"    1036";"     989";"      47";"    1038";"     990";"      48";"  137488";"  134874";"    2614";"  148948";"  143925";"    5023";"  286436";"  278862";"  256529";"   22333";"    7574";"    7574";"    7574";"       0";"       0";"       0";"       0";"       0";"       0";"       0";"       0";"       0";"       0";"       0";"       0";"       0";"       0";"       0"
"Eindhoven Airport";"2013 May";"    2621";"       0";"    1208";"    1096";"     112";"    1209";"    1096";"     113";"  169895";"  158719";"   11176";"  173053";"  161217";"   11836";"  342948";"  334689";"  298889";"   35800";"    8259";"    8259";"    8259";"       0";"       0";"       0";"       0";"       0";"       0";"       0";"       0";"       0";"       0";"       0";"       0";"       0";"       0";"       0"
"Eindhoven Airport";"2013 June";"    2533";"       0";"    1160";"    1053";"     107";"    1164";"    1058";"     106";"  162136";"  151515";"   10621";"  167802";"  157077";"   10725";"  329938";"  322829";"  289471";"   33358";"    7109";"    7109";"    7109";"       0";"       0";"       0";"       0";"       0";"       0";"       0";"       0";"       0";"       0";"       0";"       0";"       0";"       0";"       0"
"Eindhoven Airport";"2013 July";"    2682";"       0";"    1235";"    1112";"     123";"    1236";"    1113";"     123";"  174175";"  161241";"   12934";"  198507";"  184307";"   14200";"  372682";"  364642";"  324147";"   40495";"    8040";"    8040";"    8040";"       0";"       0";"       0";"       0";"       0";"       0";"       0";"       0";"       0";"       0";"       0";"       0";"       0";"       0";"       0"
"Eindhoven Airport";"2013 August";"    2633";"       0";"    1219";"    1096";"     123";"    1220";"    1097";"     123";"  194049";"  180664";"   13385";"  176255";"  165126";"   11129";"  370304";"  361368";"  324370";"   36998";"    8936";"    8936";"    8936";"       0";"       0";"       0";"       0";"       0";"       0";"       0";"       0";"       0";"       0";"       0";"       0";"       0";"       0";"       0"
"Eindhoven Airport";"2013 September";"    2607";"       0";"    1194";"    1078";"     116";"    1197";"    1080";"     117";"  177270";"  164804";"   12466";"  173735";"  161375";"   12360";"  351005";"  342871";"  308247";"   34624";"    8134";"    8134";"    8134";"       0";"       0";"       0";"       0";"       0";"       0";"       0";"       0";"       0";"       0";"       0";"       0";"       0";"       0";"       0"
"Eindhoven Airport";"2013 October";"    2516";"       0";"    1155";"    1066";"      89";"    1157";"    1069";"      88";"  174472";"  164913";"    9559";"  164311";"  157095";"    7216";"  338783";"  329788";"  294286";"   35502";"    8995";"    8995";"    8995";"       0";"       0";"       0";"       0";"       0";"       0";"       0";"       0";"       0";"       0";"       0";"       0";"       0";"       0";"       0"
"Eindhoven Airport";"2013 November";"    1816";"       0";"     823";"     794";"      29";"     827";"     798";"      29";"  115741";"  113385";"    2356";"  107579";"  105136";"    2443";"  223320";"  217027";"  203166";"   13861";"    6293";"    6293";"    6293";"       0";"       0";"       0";"       0";"       0";"       0";"       0";"       0";"       0";"       0";"       0";"       0";"       0";"       0";"       0"
"Eindhoven Airport";"2013 December";"    1745";"       0";"     801";"     781";"      20";"     801";"     781";"      20";"  100806";"   99170";"    1636";"  112346";"  110642";"    1704";"  213152";"  206433";"  194931";"   11502";"    6719";"    6719";"    6719";"       0";"       0";"       0";"       0";"       0";"       0";"       0";"       0";"       0";"       0";"       0";"       0";"       0";"       0";"       0"
"Eindhoven Airport";"2014 January";"    1932";"       0";"     895";"     867";"      28";"     892";"     867";"      25";"  109327";"  107803";"    1524";"  101439";"   99680";"    1759";"  210766";"  204498";"  192798";"   11700";"    6268";"    6268";"    6268";"       0";"       0";"       0";"       0";"       0";"       0";"       0";"       0";"       0";"       0";"       0";"       0";"       0";"       0";"       0"
"Eindhoven Airport";"2014 February";"    1763";"       0";"     814";"     794";"      20";"     814";"     794";"      20";"  103209";"  101671";"    1538";"  109168";"  107878";"    1290";"  212377";"  205962";"  195858";"   10104";"    6415";"    6415";"    6415";"       0";"       0";"       0";"       0";"       0";"       0";"       0";"       0";"       0";"       0";"       0";"       0";"       0";"       0";"       0"
"Eindhoven Airport";"2014 March";"    2053";"       0";"     949";"     928";"      21";"     949";"     928";"      21";"  131300";"  129621";"    1679";"  128130";"  126511";"    1619";"  259430";"  252568";"  237999";"   14569";"    6862";"    6862";"    6862";"       0";"       0";"       0";"       0";"       0";"       0";"       0";"       0";"       0";"       0";"       0";"       0";"       0";"       0";"       0"
"Eindhoven Airport";"2014 April";"    2542";"       0";"    1167";"    1155";"      12";"    1171";"    1157";"      14";"  161868";"  160738";"    1130";"  183878";"  181390";"    2488";"  345746";"  339890";"  310347";"   29543";"    5856";"    5856";"    5856";"       0";"       0";"       0";"       0";"       0";"       0";"       0";"       0";"       0";"       0";"       0";"       0";"       0";"       0";"       0"
"Eindhoven Airport";"2014 May";"    2948";"       0";"    1370";"    1340";"      30";"    1373";"    1342";"      31";"  206081";"  201406";"    4675";"  206724";"  201780";"    4944";"  412805";"  406415";"  365535";"   40880";"    6390";"    6390";"    6390";"       0";"       0";"       0";"       0";"       0";"       0";"       0";"       0";"       0";"       0";"       0";"       0";"       0";"       0";"       0"
"Eindhoven Airport";"2014 June";"    2868";"       0";"    1318";"    1292";"      26";"    1317";"    1292";"      25";"  200290";"  196217";"    4073";"  195410";"  191668";"    3742";"  395700";"  390107";"  356367";"   33740";"    5593";"    5593";"    5593";"       0";"       0";"       0";"       0";"       0";"       0";"       0";"       0";"       0";"       0";"       0";"       0";"       0";"       0";"       0"
"Eindhoven Airport";"2014 July";"    2897";"       0";"    1339";"    1315";"      24";"    1343";"    1321";"      22";"  191198";"  187940";"    3258";"  222401";"  218499";"    3902";"  413599";"  408873";"  372473";"   36400";"    4726";"    4726";"    4726";"       0";"       0";"       0";"       0";"       0";"       0";"       0";"       0";"       0";"       0";"       0";"       0";"       0";"       0";"       0"
"Eindhoven Airport";"2014 August";"    2880";"       0";"    1359";"    1333";"      26";"    1361";"    1335";"      26";"  227796";"  223450";"    4346";"  206816";"  203137";"    3679";"  434612";"  427071";"  386587";"   40484";"    7541";"    7541";"    7541";"       0";"       0";"       0";"       0";"       0";"       0";"       0";"       0";"       0";"       0";"       0";"       0";"       0";"       0";"       0"
"Eindhoven Airport";"2014 September";"    2831";"       0";"    1308";"    1273";"      35";"    1310";"    1275";"      35";"  198870";"  193654";"    5216";"  193829";"  188439";"    5390";"  392699";"  386444";"  351351";"   35093";"    6255";"    6255";"    6255";"       0";"       0";"       0";"       0";"       0";"       0";"       0";"       0";"       0";"       0";"       0";"       0";"       0";"       0";"       0"
"Eindhoven Airport";"2014 October";"    2694";"       0";"    1267";"    1245";"      22";"    1268";"    1246";"      22";"  196824";"  193206";"    3618";"  185659";"  182672";"    2987";"  382483";"  375488";"  340776";"   34712";"    6995";"    6995";"    6995";"       0";"       0";"       0";"       0";"       0";"       0";"       0";"       0";"       0";"       0";"       0";"       0";"       0";"       0";"       0"
"Eindhoven Airport";"2014 November";"    1826";"       0";"     852";"     849";"       3";"     850";"     847";"       3";"  129954";"  129483";"     471";"  119698";"  119230";"     468";"  249652";"  238022";"  225610";"   12412";"   11630";"   11630";"   11630";"       0";"       0";"       0";"       0";"       0";"       0";"       0";"       0";"       0";"       0";"       0";"       0";"       0";"       0";"       0"
"Eindhoven Airport";"2014 December";"    1899";"       0";"     868";"     868";"       0";"     869";"     869";"       0";"  117617";"  117617";"       0";"  128878";"  128878";"       0";"  246495";"  237270";"  227262";"   10008";"    9225";"    9225";"    9225";"       0";"       0";"       0";"       0";"       0";"       0";"       0";"       0";"       0";"       0";"       0";"       0";"       0";"       0";"       0"
"Eindhoven Airport";"2015 January";"    1980";"       2";"     922";"     906";"      16";"     922";"     909";"      13";"  127672";"  127133";"     539";"  119515";"  119004";"     511";"  247187";"  236407";"  226449";"    9958";"   10780";"   10545";"   10545";"       0";"       0";"       0";"       0";"     235";"       0";"     235";"       0";"       0";"       0";"       0";"       0";"       0";"       0";"       0"
"Eindhoven Airport";"2015 February";"    1903";"       0";"     897";"     875";"      22";"     897";"     878";"      19";"  123794";"  123407";"     387";"  131297";"  131038";"     259";"  255091";"  245053";"  233813";"   11240";"   10038";"   10038";"   10038";"       0";"       0";"       0";"       0";"       0";"       0";"       0";"       0";"       0";"       0";"       0";"       0";"       0";"       0";"       0"
"Eindhoven Airport";"2015 March";"    2339";"       0";"    1102";"    1082";"      20";"    1098";"    1086";"      12";"  157001";"  156807";"     194";"  156991";"  156951";"      40";"  313992";"  302797";"  288258";"   14539";"   11195";"   11195";"   11195";"       0";"       0";"       0";"       0";"       0";"       0";"       0";"       0";"       0";"       0";"       0";"       0";"       0";"       0";"       0"
"Eindhoven Airport";"2015 April";"    2695";"       4";"    1266";"    1242";"      24";"    1270";"    1244";"      26";"  184832";"  183690";"    1142";"  201212";"  198951";"    2261";"  386044";"  374599";"  346026";"   28573";"   11445";"   11445";"   11445";"       0";"       0";"       0";"       0";"       0";"       0";"       0";"       0";"       0";"       0";"       0";"       0";"       0";"       0";"       0"
"Eindhoven Airport";"2015 May";"    2980";"       0";"    1417";"    1381";"      36";"    1418";"    1379";"      39";"  223633";"  219760";"    3873";"  222864";"  218982";"    3882";"  446497";"  437592";"  396055";"   41537";"    8905";"    8905";"    8905";"       0";"       0";"       0";"       0";"       0";"       0";"       0";"       0";"       0";"       0";"       0";"       0";"       0";"       0";"       0"
"Eindhoven Airport";"2015 June";"    2948";"       0";"    1377";"    1334";"      43";"    1375";"    1338";"      37";"  211387";"  206865";"    4522";"  214634";"  210435";"    4199";"  426021";"  418175";"  383188";"   34987";"    7846";"    7846";"    7846";"       0";"       0";"       0";"       0";"       0";"       0";"       0";"       0";"       0";"       0";"       0";"       0";"       0";"       0";"       0"
"Eindhoven Airport";"2015 July";"    3009";"       4";"    1426";"    1391";"      35";"    1429";"    1396";"      33";"  209319";"  206228";"    3091";"  238263";"  234740";"    3523";"  447582";"  440220";"  401767";"   38453";"    7362";"    7362";"    7362";"       0";"       0";"       0";"       0";"       0";"       0";"       0";"       0";"       0";"       0";"       0";"       0";"       0";"       0";"       0"
"Eindhoven Airport";"2015 August";"    3016";"       1";"    1426";"    1389";"      37";"    1425";"    1392";"      33";"  238630";"  235147";"    3483";"  219508";"  216283";"    3225";"  458138";"  449825";"  410300";"   39525";"    8313";"    8313";"    8313";"       0";"       0";"       0";"       0";"       0";"       0";"       0";"       0";"       0";"       0";"       0";"       0";"       0";"       0";"       0"
"Eindhoven Airport";"2015 September";"    2879";"       4";"    1370";"    1317";"      53";"    1371";"    1323";"      48";"  215933";"  210892";"    5041";"  212815";"  207561";"    5254";"  428748";"  420171";"  384854";"   35317";"    8577";"    8577";"    8577";"       0";"       0";"       0";"       0";"       0";"       0";"       0";"       0";"       0";"       0";"       0";"       0";"       0";"       0";"       0"
"Eindhoven Airport";"2015 October";"    2846";"       8";"    1354";"    1309";"      45";"    1354";"    1312";"      42";"  216939";"  212827";"    4112";"  204549";"  201030";"    3519";"  421488";"  412545";"  379793";"   32752";"    8943";"    8943";"    8943";"       0";"       0";"       0";"       0";"       0";"       0";"       0";"       0";"       0";"       0";"       0";"       0";"       0";"       0";"       0"
"Eindhoven Airport";"2015 November";"    1955";"       0";"     916";"     882";"      34";"     917";"     886";"      31";"  140883";"  139555";"    1328";"  130107";"  128767";"    1340";"  270990";"  260291";"  248133";"   12158";"   10699";"   10699";"   10699";"       0";"       0";"       0";"       0";"       0";"       0";"       0";"       0";"       0";"       0";"       0";"       0";"       0";"       0";"       0"
"Eindhoven Airport";"2015 December";"    2012";"       0";"     944";"     911";"      33";"     942";"     918";"      24";"  129192";"  127353";"    1839";"  142912";"  140904";"    2008";"  272104";"  262153";"  250105";"   12048";"    9951";"    9951";"    9951";"       0";"       0";"       0";"       0";"       0";"       0";"       0";"       0";"       0";"       0";"       0";"       0";"       0";"       0";"       0"
"Eindhoven Airport";"2016 January";"    2075";"       0";"     983";"     957";"      26";"     987";"     959";"      28";"  143665";"  141350";"    2315";"  134131";"  131970";"    2161";"  277796";"  269391";"  259509";"    9882";"    8405";"    8405";"    8405";"       0";"       0";"       0";"       0";"       0";"       0";"       0";"       0";"       0";"       0";"       0";"       0";"       0";"       0";"       0"
"Eindhoven Airport";"2016 February";"    2118";"       0";"     992";"     974";"      18";"     991";"     973";"      18";"  144367";"  142798";"    1569";"  150124";"  148691";"    1433";"  294491";"  285783";"  277418";"    8365";"    8708";"    8708";"    8708";"       0";"       0";"       0";"       0";"       0";"       0";"       0";"       0";"       0";"       0";"       0";"       0";"       0";"       0";"       0"
"Eindhoven Airport";"2016 March";"    2559";"       0";"    1199";"    1155";"      44";"    1203";"    1171";"      32";"  175806";"  173869";"    1937";"  182249";"  179659";"    2590";"  358055";"  350453";"  337239";"   13214";"    7602";"    7602";"    7602";"       0";"       0";"       0";"       0";"       0";"       0";"       0";"       0";"       0";"       0";"       0";"       0";"       0";"       0";"       0"
"Eindhoven Airport";"2016 April";"    2947";"       0";"    1390";"    1355";"      35";"    1390";"    1359";"      31";"  204641";"  202422";"    2219";"  223915";"  221079";"    2836";"  428556";"  420237";"  402458";"   17779";"    8319";"    8319";"    8319";"       0";"       0";"       0";"       0";"       0";"       0";"       0";"       0";"       0";"       0";"       0";"       0";"       0";"       0";"       0"
"Eindhoven Airport";"2016 May";"    3111";"       0";"    1469";"    1419";"      50";"    1476";"    1426";"      50";"  234778";"  230548";"    4230";"  218570";"  215608";"    2962";"  453348";"  444217";"  418508";"   25709";"    9131";"    9131";"    9131";"       0";"       0";"       0";"       0";"       0";"       0";"       0";"       0";"       0";"       0";"       0";"       0";"       0";"       0";"       0"
"Eindhoven Airport";"2016 June";"    1642";"       0";"     775";"     738";"      37";"     767";"     742";"      25";"  106523";"  104949";"    1574";"  125204";"  122376";"    2828";"  231727";"  227713";"  216850";"   10863";"    4014";"    4014";"    4014";"       0";"       0";"       0";"       0";"       0";"       0";"       0";"       0";"       0";"       0";"       0";"       0";"       0";"       0";"       0"
"Eindhoven Airport";"2016 July";"    3348";"       0";"    1584";"    1527";"      57";"    1587";"    1525";"      62";"  239598";"  234393";"    5205";"  268101";"  262044";"    6057";"  507699";"  499627";"  473074";"   26553";"    8072";"    8072";"    8072";"       0";"       0";"       0";"       0";"       0";"       0";"       0";"       0";"       0";"       0";"       0";"       0";"       0";"       0";"       0"
"Eindhoven Airport";"2016 August";"    3316";"       0";"    1579";"    1518";"      61";"    1578";"    1520";"      58";"  266348";"  260389";"    5959";"  250233";"  244300";"    5933";"  516581";"  507733";"  476271";"   31462";"    8848";"    8848";"    8848";"       0";"       0";"       0";"       0";"       0";"       0";"       0";"       0";"       0";"       0";"       0";"       0";"       0";"       0";"       0"
"Eindhoven Airport";"2016 September";"    3357";"       0";"    1596";"    1537";"      59";"    1596";"    1540";"      56";"  256004";"  250690";"    5314";"  251105";"  245840";"    5265";"  507109";"  498764";"  474106";"   24658";"    8345";"    8345";"    8345";"       0";"       0";"       0";"       0";"       0";"       0";"       0";"       0";"       0";"       0";"       0";"       0";"       0";"       0";"       0"
"Eindhoven Airport";"2016 October";"    3248";"       0";"    1548";"    1466";"      82";"    1548";"    1480";"      68";"  250067";"  243841";"    6226";"  240045";"  235193";"    4852";"  490112";"  480715";"  458322";"   22393";"    9397";"    9397";"    9397";"       0";"       0";"       0";"       0";"       0";"       0";"       0";"       0";"       0";"       0";"       0";"       0";"       0";"       0";"       0"
"Eindhoven Airport";"2016 November";"    2478";"       0";"    1169";"    1139";"      30";"    1171";"    1139";"      32";"  184996";"  183944";"    1052";"  174273";"  173117";"    1156";"  359269";"  347837";"  337738";"   10099";"   11432";"   11432";"   11432";"       0";"       0";"       0";"       0";"       0";"       0";"       0";"       0";"       0";"       0";"       0";"       0";"       0";"       0";"       0"
"Eindhoven Airport";"2016 December";"    2458";"       2";"    1164";"    1133";"      31";"    1168";"    1147";"      21";"  169242";"  167903";"    1339";"  186212";"  185422";"     790";"  355454";"  342494";"  331402";"   11092";"   12960";"   12960";"   12960";"       0";"       0";"       0";"       0";"       0";"       0";"       0";"       0";"       0";"       0";"       0";"       0";"       0";"       0";"       0"
"Eindhoven Airport";"2017 January";"    2545";"       0";"    1199";"    1166";"      33";"    1195";"    1172";"      23";"  180481";"  179672";"     809";"  168873";"  168133";"     740";"  349354";"  336557";"  326194";"   10363";"   12797";"   12797";"   12797";"       0";"       0";"       0";"       0";"       0";"       0";"       0";"       0";"       0";"       0";"       0";"       0";"       0";"       0";"       0"
"Eindhoven Airport";"2017 February";"    2390";"       0";"    1120";"    1100";"      20";"    1121";"    1104";"      17";"  168232";"  167612";"     620";"  179290";"  178603";"     687";"  347522";"  336189";"  326028";"   10161";"   11333";"   11333";"   11333";"       0";"       0";"       0";"       0";"       0";"       0";"       0";"       0";"       0";"       0";"       0";"       0";"       0";"       0";"       0"
"Eindhoven Airport";"2017 March";"    2748";"       0";"    1330";"    1307";"      23";"    1330";"    1309";"      21";"  208919";"  208230";"     689";"  207786";"  207117";"     669";"  416705";"  403856";"  393156";"   10700";"   12849";"   12849";"   12849";"       0";"       0";"       0";"       0";"       0";"       0";"       0";"       0";"       0";"       0";"       0";"       0";"       0";"       0";"       0"
"Eindhoven Airport";"2017 April";"    3203";"       0";"    1530";"    1500";"      30";"    1529";"    1507";"      22";"  242888";"  241739";"    1149";"  260141";"  258600";"    1541";"  503029";"  490799";"  473170";"   17629";"   12230";"   12230";"   12230";"       0";"       0";"       0";"       0";"       0";"       0";"       0";"       0";"       0";"       0";"       0";"       0";"       0";"       0";"       0"
"Eindhoven Airport";"2017 May";"    3505";"       0";"    1651";"    1614";"      37";"    1651";"    1615";"      36";"  272007";"  268713";"    3294";"  272790";"  269387";"    3403";"  544797";"  533251";"  511315";"   21936";"   11546";"   11546";"   11546";"       0";"       0";"       0";"       0";"       0";"       0";"       0";"       0";"       0";"       0";"       0";"       0";"       0";"       0";"       0"
"Eindhoven Airport";"2017 June";"    3312";"       0";"    1617";"    1569";"      48";"    1616";"    1570";"      46";"  264225";"  260179";"    4046";"  267878";"  263594";"    4284";"  532103";"  522645";"  500361";"   22284";"    9458";"    9458";"    9458";"       0";"       0";"       0";"       0";"       0";"       0";"       0";"       0";"       0";"       0";"       0";"       0";"       0";"       0";"       0"
"Eindhoven Airport";"2017 July";"    3480";"       0";"    1666";"    1609";"      57";"    1666";"    1614";"      52";"  268137";"  263678";"    4459";"  298916";"  293886";"    5030";"  567053";"  555499";"  525882";"   29617";"   11554";"   11554";"   11554";"       0";"       0";"       0";"       0";"       0";"       0";"       0";"       0";"       0";"       0";"       0";"       0";"       0";"       0";"       0"
"Eindhoven Airport";"2017 August";"    3495";"       0";"    1668";"    1611";"      57";"    1667";"    1613";"      54";"  296811";"  291974";"    4837";"  280309";"  275816";"    4493";"  577120";"  563967";"  533146";"   30821";"   13153";"   13153";"   13153";"       0";"       0";"       0";"       0";"       0";"       0";"       0";"       0";"       0";"       0";"       0";"       0";"       0";"       0";"       0"
"Eindhoven Airport";"2017 September";"    3378";"       0";"    1633";"    1583";"      50";"    1634";"    1585";"      49";"  278361";"  273982";"    4379";"  274735";"  270238";"    4497";"  553096";"  542224";"  513779";"   28445";"   10872";"   10872";"   10872";"       0";"       0";"       0";"       0";"       0";"       0";"       0";"       0";"       0";"       0";"       0";"       0";"       0";"       0";"       0"
"Eindhoven Airport";"2017 October";"    3314";"       0";"    1607";"    1563";"      44";"    1607";"    1564";"      43";"  274190";"  271035";"    3155";"  262546";"  260297";"    2249";"  536736";"  524163";"  504180";"   19983";"   12573";"   12573";"   12573";"       0";"       0";"       0";"       0";"       0";"       0";"       0";"       0";"       0";"       0";"       0";"       0";"       0";"       0";"       0"
"Eindhoven Airport";"2017 November";"    2617";"       0";"    1249";"    1223";"      26";"    1250";"    1223";"      27";"  207259";"  206328";"     931";"  193777";"  192852";"     925";"  401036";"  382674";"  372136";"   10538";"   18362";"   16296";"   16296";"       0";"       0";"       0";"       0";"       0";"       0";"       0";"       0";"    2066";"    2066";"       0";"       0";"       0";"       0";"       0"
"Eindhoven Airport";"2017 December";"    2500";"       0";"    1197";"    1155";"      42";"    1196";"    1181";"      15";"  175621";"  174975";"     646";"  197048";"  196457";"     591";"  372669";"  355774";"  342841";"   12933";"   16895";"   14867";"   14867";"       0";"       0";"       0";"       0";"       0";"       0";"       0";"       0";"    2028";"    2028";"       0";"       0";"       0";"       0";"       0"
"Eindhoven Airport";"2018 January";"    2747";"       0";"    1307";"    1287";"      20";"    1308";"    1293";"      15";"  206081";"  205472";"     609";"  192008";"  191371";"     637";"  398089";"  381354";"  368980";"   12374";"   16735";"   15413";"   15413";"       0";"       0";"       0";"       0";"       0";"       0";"       0";"       0";"    1322";"    1322";"       0";"       0";"       0";"       0";"       0"
"Eindhoven Airport";"2018 February";"    2556";"       0";"    1209";"    1194";"      15";"    1208";"    1198";"      10";"  191966";"  191324";"     642";"  201114";"  200408";"     706";"  393080";"  375144";"  364777";"   10367";"   17936";"   15816";"   15816";"       0";"       0";"       0";"       0";"       0";"       0";"       0";"       0";"    2120";"    2120";"       0";"       0";"       0";"       0";"       0"
"Eindhoven Airport";"2018 March";"    2899";"       0";"    1386";"    1368";"      18";"    1388";"    1376";"      12";"  223641";"  223131";"     510";"  228449";"  227797";"     652";"  452090";"  431857";"  421409";"   10448";"   20233";"   17469";"   17469";"       0";"       0";"       0";"       0";"       0";"       0";"       0";"       0";"    2764";"    2764";"       0";"       0";"       0";"       0";"       0"
"Eindhoven Airport";"2018 April";"    3258";"       2";"    1577";"    1540";"      37";"    1574";"    1550";"      24";"  261765";"  260120";"    1645";"  275483";"  272796";"    2687";"  537248";"  513978";"  497895";"   16083";"   23270";"   18921";"   18921";"       0";"       0";"       0";"       0";"       0";"       0";"       0";"       0";"    4349";"    4349";"       0";"       0";"       0";"       0";"       0"
"Eindhoven Airport";"2018 May";"    3576";"       0";"    1704";"    1648";"      56";"    1704";"    1666";"      38";"  291447";"  285831";"    5616";"  294340";"  288025";"    6315";"  585787";"  562972";"  539248";"   23724";"   22815";"   18412";"   18412";"       0";"       0";"       0";"       0";"       0";"       0";"       0";"       0";"    4403";"    4403";"       0";"       0";"       0";"       0";"       0"
"Eindhoven Airport";"2018 June";"    3549";"       0";"    1703";"    1647";"      56";"    1703";"    1653";"      50";"  288433";"  282070";"    6363";"  295313";"  288438";"    6875";"  583746";"  562550";"  536404";"   26146";"   21196";"   16779";"   16779";"       0";"       0";"       0";"       0";"       0";"       0";"       0";"       0";"    4417";"    4417";"       0";"       0";"       0";"       0";"       0"
"Eindhoven Airport";"2018 July";"    3737";"       0";"    1796";"    1741";"      55";"    1796";"    1752";"      44";"  294736";"  288182";"    6554";"  328972";"  322148";"    6824";"  623708";"  598151";"  567019";"   31132";"   25557";"   20916";"   20916";"       0";"       0";"       0";"       0";"       0";"       0";"       0";"       0";"    4641";"    4641";"       0";"       0";"       0";"       0";"       0"
"Eindhoven Airport";"2018 August";"    3763";"       0";"    1818";"    1765";"      53";"    1818";"    1771";"      47";"  327843";"  321277";"    6566";"  307781";"  301396";"    6385";"  635624";"  606885";"  573854";"   33031";"   28739";"   23688";"   23688";"       0";"       0";"       0";"       0";"       0";"       0";"       0";"       0";"    5051";"    5051";"       0";"       0";"       0";"       0";"       0"
"Eindhoven Airport";"2018 September";"    3686";"       0";"    1773";"    1720";"      53";"    1773";"    1722";"      51";"  311332";"  305019";"    6313";"  303869";"  297280";"    6589";"  615201";"  589550";"  561936";"   27614";"   25651";"   21825";"   21825";"       0";"       0";"       0";"       0";"       0";"       0";"       0";"       0";"    3826";"    3826";"       0";"       0";"       0";"       0";"       0"
"Eindhoven Airport";"2018 October";"    3726";"       0";"    1795";"    1737";"      58";"    1795";"    1743";"      52";"  313557";"  306786";"    6771";"  299348";"  294398";"    4950";"  612905";"  585662";"  559606";"   26056";"   27243";"   22505";"   22505";"       0";"       0";"       0";"       0";"       0";"       0";"       0";"       0";"    4738";"    4738";"       0";"       0";"       0";"       0";"       0"
"Eindhoven Airport";"2018 November";"    2590";"       0";"    1234";"    1192";"      42";"    1239";"    1193";"      46";"  209688";"  205783";"    3905";"  199940";"  194650";"    5290";"  409628";"  383344";"  371022";"   12322";"   26284";"   22370";"   18903";"    3467";"       0";"       0";"       0";"       0";"       0";"       0";"       0";"    3914";"    3914";"       0";"       0";"       0";"       0";"       0"
"Eindhoven Airport";"2018 December";"    2558";"       0";"    1214";"    1154";"      60";"    1213";"    1174";"      39";"  185943";"  181238";"    4705";"  204706";"  199572";"    5134";"  390649";"  366861";"  351096";"   15765";"   23788";"   20926";"   16911";"    4015";"       0";"       0";"       0";"       0";"       0";"       0";"       0";"    2862";"    2862";"       0";"       0";"       0";"       0";"       0"
"Eindhoven Airport";"2019 January";"    2694";"       0";"    1289";"    1242";"      47";"    1290";"    1247";"      43";"  206935";"  201515";"    5420";"  193546";"  188027";"    5519";"  400481";"  375089";"  358122";"   16967";"   25392";"   22787";"   17972";"    4815";"       0";"       0";"       0";"       0";"       0";"       0";"       0";"    2605";"    2605";"       0";"       0";"       0";"       0";"       0"
"Eindhoven Airport";"2019 February";"    2534";"       0";"    1209";"    1171";"      38";"    1208";"    1173";"      35";"  198594";"  193407";"    5187";"  206367";"  200895";"    5472";"  404961";"  378663";"  363725";"   14938";"   26298";"   23692";"   19325";"    4367";"       0";"       0";"       0";"       0";"       0";"       0";"       0";"    2606";"    2606";"       0";"       0";"       0";"       0";"       0"
"Eindhoven Airport";"2019 March";"    2986";"       0";"    1427";"    1385";"      42";"    1427";"    1392";"      35";"  243926";"  238801";"    5125";"  242410";"  237389";"    5021";"  486336";"  454150";"  436945";"   17205";"   32186";"   27731";"   23315";"    4416";"       0";"       0";"       0";"       0";"       0";"       0";"       0";"    4455";"    4455";"       0";"       0";"       0";"       0";"       0"
"Eindhoven Airport";"2019 April";"    3677";"       0";"    1786";"    1738";"      48";"    1787";"    1759";"      28";"  291947";"  291947";"       0";"  314543";"  314411";"     132";"  606490";"  575402";"  542139";"   33263";"   31088";"   26496";"   24349";"    2147";"       0";"       0";"       0";"       0";"       0";"       0";"       0";"    4592";"    4592";"       0";"       0";"       0";"       0";"       0"
"Eindhoven Airport";"2019 May";"    4045";"       0";"    1963";"    1911";"      52";"    1970";"    1918";"      52";"  326219";"  325613";"     606";"  329880";"  329592";"     288";"  656099";"  631507";"  591522";"   39985";"   24592";"   19296";"   19296";"       0";"       0";"       0";"       0";"       0";"       0";"       0";"       0";"    5296";"    5296";"       0";"       0";"       0";"       0";"       0"
"Eindhoven Airport";"2019 June";"    3931";"       0";"    1919";"    1874";"      45";"    1917";"    1879";"      38";"  327515";"  327334";"     181";"  330133";"  329955";"     178";"  657648";"  628373";"  588560";"   39813";"   29275";"   24218";"   24218";"       0";"       0";"       0";"       0";"       0";"       0";"       0";"       0";"    5057";"    5057";"       0";"       0";"       0";"       0";"       0"
"Eindhoven Airport";"2019 July";"    4017";"       0";"    1961";"    1910";"      51";"    1961";"    1921";"      40";"  312064";"  311870";"     194";"  353574";"  353335";"     239";"  665638";"  633847";"  587341";"   46506";"   31791";"   24770";"   24770";"       0";"       0";"       0";"       0";"       0";"       0";"       0";"       0";"    7021";"    7021";"       0";"       0";"       0";"       0";"       0"
"Eindhoven Airport";"2019 August";"    4020";"       0";"    1965";"    1916";"      49";"    1968";"    1920";"      48";"  351710";"  351168";"     542";"  329383";"  328762";"     621";"  681093";"  648004";"  598181";"   49823";"   33089";"   25981";"   25981";"       0";"       0";"       0";"       0";"       0";"       0";"       0";"       0";"    7108";"    7108";"       0";"       0";"       0";"       0";"       0"
"Eindhoven Airport";"2019 September";"    4016";"       0";"    1952";"    1915";"      37";"    1961";"    1916";"      45";"  339392";"  339099";"     293";"  332963";"  332618";"     345";"  672355";"  641495";"  597501";"   43994";"   30860";"   25638";"   25638";"       0";"       0";"       0";"       0";"       0";"       0";"       0";"       0";"    5222";"    5222";"       0";"       0";"       0";"       0";"       0"
"Eindhoven Airport";"2019 October";"    3957";"       0";"    1937";"    1890";"      47";"    1933";"    1877";"      56";"  339167";"  338786";"     381";"  323071";"  322851";"     220";"  662238";"  630181";"  586648";"   43533";"   32057";"   27795";"   24749";"    3046";"       0";"       0";"       0";"       0";"       0";"       0";"       0";"    4262";"    4262";"       0";"       0";"       0";"       0";"       0"
"Eindhoven Airport";"2019 November";"    2741";"       0";"    1315";"    1288";"      27";"    1326";"    1292";"      34";"  229154";"  228861";"     293";"  217776";"  217485";"     291";"  446930";"  417528";"  396673";"   20855";"   29402";"   25165";"   21167";"    3998";"       0";"       0";"       0";"       0";"       0";"       0";"       0";"    4237";"    4237";"       0";"       0";"       0";"       0";"       0"
"Eindhoven Airport";"2019 December";"    2823";"       0";"    1369";"    1312";"      57";"    1369";"    1336";"      33";"  207147";"  207058";"      89";"  233359";"  233268";"      91";"  440506";"  413878";"  391274";"   22604";"   26628";"   22613";"   18992";"    3621";"       0";"       0";"       0";"       0";"       0";"       0";"       0";"    4015";"    4015";"       0";"       0";"       0";"       0";"       0"
"Eindhoven Airport";"2020 January*";"    2633";"       0";"    1277";"    1213";"      64";"    1277";"    1256";"      21";"  202475";"  202420";"      55";"  198516";"  198469";"      47";"  400991";"  375641";"  358273";"   17368";"   25350";"   22934";"   19445";"    3489";"       0";"       0";"       0";"       0";"       0";"       0";"       0";"    2416";"    2416";"       0";"       0";"       0";"       0";"       0"
"Eindhoven Airport";"2020 February*";"    2747";"       0";"    1328";"    1291";"      37";"    1321";"    1292";"      29";"  214069";"  213857";"     212";"  224759";"  224380";"     379";"  438828";"  410047";"  391035";"   19012";"   28781";"   25256";"   20734";"    4522";"       0";"       0";"       0";"       0";"       0";"       0";"       0";"    3525";"    3525";"       0";"       0";"       0";"       0";"       0"
"Eindhoven Airport";"2020 March*";"    1936";"       0";"     939";"     925";"      14";"     949";"     909";"      40";"  121612";"  121164";"     448";"  103459";"  103459";"       0";"  225071";"  210026";"  200631";"    9395";"   15045";"   13812";"   11222";"    2590";"       0";"       0";"       0";"       0";"       0";"       0";"       0";"    1233";"    1233";"       0";"       0";"       0";"       0";"       0"
"Eindhoven Airport";"2020 April*";"     158";"       0";"      75";"      58";"      17";"      73";"      58";"      15";"    4740";"    3304";"    1436";"    2992";"    2964";"      28";"    7732";"    7732";"    7704";"      28";"       0";"       0";"       0";"       0";"       0";"       0";"       0";"       0";"       0";"       0";"       0";"       0";"       0";"       0";"       0";"       0";"       0";"       0"
"Eindhoven Airport";"2020 May*";"     205";"       0";"      92";"      75";"      17";"      86";"      75";"      11";"    7472";"    6867";"     605";"    4636";"    4636";"       0";"   12108";"   12108";"   11925";"     183";"       0";"       0";"       0";"       0";"       0";"       0";"       0";"       0";"       0";"       0";"       0";"       0";"       0";"       0";"       0";"       0";"       0";"       0"
"Eindhoven Airport";"2020 June*";"     658";"       1";"     286";"     257";"      29";"     279";"     260";"      19";"   19688";"   19688";"       0";"   27086";"   27086";"       0";"   46774";"   46774";"   43061";"    3713";"       0";"       0";"       0";"       0";"       0";"       0";"       0";"       0";"       0";"       0";"       0";"       0";"       0";"       0";"       0";"       0";"       0";"       0"
"Eindhoven Airport";"2020 July*";"    2405";"       0";"    1152";"    1113";"      39";"    1140";"    1114";"      26";"  112453";"  112453";"       0";"  145062";"  145062";"       0";"  257515";"  257515";"  248672";"    8843";"       0";"       0";"       0";"       0";"       0";"       0";"       0";"       0";"       0";"       0";"       0";"       0";"       0";"       0";"       0";"       0";"       0";"       0"
"Eindhoven Airport";"2020 August*";"    2846";"       0";"    1352";"    1324";"      28";"    1361";"    1327";"      34";"  162305";"  162227";"      78";"  132748";"  132670";"      78";"  295053";"  295053";"  286207";"    8846";"       0";"       0";"       0";"       0";"       0";"       0";"       0";"       0";"       0";"       0";"       0";"       0";"       0";"       0";"       0";"       0";"       0";"       0"
"Eindhoven Airport";"2020 September*";"    2078";"       0";"     973";"     942";"      31";"     974";"     942";"      32";"   90205";"   90071";"     134";"   81170";"   80979";"     191";"  171375";"  171375";"  164985";"    6390";"       0";"       0";"       0";"       0";"       0";"       0";"       0";"       0";"       0";"       0";"       0";"       0";"       0";"       0";"       0";"       0";"       0";"       0"
"Eindhoven Airport";"2020 October*";"    1524";"       0";"     724";"     696";"      28";"     727";"     699";"      28";"   68212";"   67984";"     228";"   64845";"   64736";"     109";"  133057";"  133057";"  127633";"    5424";"       0";"       0";"       0";"       0";"       0";"       0";"       0";"       0";"       0";"       0";"       0";"       0";"       0";"       0";"       0";"       0";"       0";"       0"
"Eindhoven Airport";"2020 November*";"     779";"       0";"     363";"     349";"      14";"     358";"     349";"       9";"   31566";"   31464";"     102";"   26171";"   26073";"      98";"   57737";"   57737";"   54090";"    3647";"       0";"       0";"       0";"       0";"       0";"       0";"       0";"       0";"       0";"       0";"       0";"       0";"       0";"       0";"       0";"       0";"       0";"       0"
"Eindhoven Airport";"2020 December*";"     852";"       0";"     387";"     362";"      25";"     382";"     362";"      20";"   26518";"   26267";"     251";"   40026";"   39777";"     249";"   66544";"   66544";"   62078";"    4466";"       0";"       0";"       0";"       0";"       0";"       0";"       0";"       0";"       0";"       0";"       0";"       0";"       0";"       0";"       0";"       0";"       0";"       0"
"Eindhoven Airport";"2021 January*";"     609";"       0";"     282";"     273";"       9";"     290";"     274";"      16";"   22761";"   22761";"       0";"   13367";"   13367";"       0";"   36128";"   36128";"   32218";"    3910";"       0";"       0";"       0";"       0";"       0";"       0";"       0";"       0";"       0";"       0";"       0";"       0";"       0";"       0";"       0";"       0";"       0";"       0"
"Eindhoven Airport";"2021 February*";"     185";"       0";"      86";"      72";"      14";"      83";"      72";"      11";"    5599";"    5493";"     106";"    5715";"    5609";"     106";"   11314";"   10985";"    9366";"    1619";"     329";"     329";"     329";"       0";"       0";"       0";"       0";"       0";"       0";"       0";"       0";"       0";"       0";"       0";"       0";"       0";"       0";"       0"
"Eindhoven Airport";"2021 March*";"     274";"       0";"     114";"      98";"      16";"     112";"      98";"      14";"    7397";"    7397";"       0";"    8603";"    8603";"       0";"   16000";"   16000";"   13688";"    2312";"       0";"       0";"       0";"       0";"       0";"       0";"       0";"       0";"       0";"       0";"       0";"       0";"       0";"       0";"       0";"       0";"       0";"       0"
"Eindhoven Airport";"2021 April*";"     436";"       0";"     190";"     167";"      23";"     183";"     167";"      16";"   12367";"   12367";"       0";"   15438";"   15438";"       0";"   27805";"   27805";"   23870";"    3935";"       0";"       0";"       0";"       0";"       0";"       0";"       0";"       0";"       0";"       0";"       0";"       0";"       0";"       0";"       0";"       0";"       0";"       0"
"Eindhoven Airport";"2021 May*";"     673";"       0";"     280";"     250";"      30";"     282";"     250";"      32";"   24310";"   24310";"       0";"   27488";"   27488";"       0";"   51798";"   51798";"   45658";"    6140";"       0";"       0";"       0";"       0";"       0";"       0";"       0";"       0";"       0";"       0";"       0";"       0";"       0";"       0";"       0";"       0";"       0";"       0"
"Eindhoven Airport";"2021 June*";"    1570";"       0";"     722";"     669";"      53";"     706";"     672";"      34";"   65258";"   65138";"     120";"   82350";"   82116";"     234";"  147608";"  142960";"  135698";"    7262";"    4648";"    4648";"    4648";"       0";"       0";"       0";"       0";"       0";"       0";"       0";"       0";"       0";"       0";"       0";"       0";"       0";"       0";"       0"
"Eindhoven Airport";"2021 July*";"    2931";"       0";"    1396";"    1314";"      82";"    1383";"    1320";"      63";"  149673";"  149405";"     268";"  195135";"  194841";"     294";"  344808";"  328995";"  300153";"   28842";"   15813";"   15813";"   15813";"       0";"       0";"       0";"       0";"       0";"       0";"       0";"       0";"       0";"       0";"       0";"       0";"       0";"       0";"       0"
"Eindhoven Airport";"2021 August*";"    3393";"       0";"    1616";"    1559";"      57";"    1629";"    1557";"      72";"  252858";"  252468";"     390";"  228718";"  228488";"     230";"  481576";"  460773";"  423054";"   37719";"   20803";"   20803";"   20803";"       0";"       0";"       0";"       0";"       0";"       0";"       0";"       0";"       0";"       0";"       0";"       0";"       0";"       0";"       0"
"Eindhoven Airport";"2021 September*";"    3229";"       0";"    1555";"    1493";"      62";"    1557";"    1493";"      64";"  233057";"  232629";"     428";"  220470";"  219924";"     546";"  453527";"  440601";"  414376";"   26225";"   12926";"   12926";"   12926";"       0";"       0";"       0";"       0";"       0";"       0";"       0";"       0";"       0";"       0";"       0";"       0";"       0";"       0";"       0"
"Eindhoven Airport";"2021 October*";"    3252";"       0";"    1550";"    1477";"      73";"    1547";"    1482";"      65";"  242080";"  241682";"     398";"  237886";"  237712";"     174";"  479966";"  470038";"  438627";"   31411";"    9928";"    9928";"    9928";"       0";"       0";"       0";"       0";"       0";"       0";"       0";"       0";"       0";"       0";"       0";"       0";"       0";"       0";"       0"
"Eindhoven Airport";"2021 November*";"    2489";"       0";"    1192";"    1143";"      49";"    1198";"    1158";"      40";"  177372";"  176923";"     449";"  164268";"  163874";"     394";"  341640";"  341299";"  306538";"   34761";"     341";"     341";"     341";"       0";"       0";"       0";"       0";"       0";"       0";"       0";"       0";"       0";"       0";"       0";"       0";"       0";"       0";"       0"
"Eindhoven Airport";"2021 December*";"    2665";"       0";"    1291";"    1243";"      48";"    1280";"    1249";"      31";"  133388";"  133238";"     150";"  172866";"  172459";"     407";"  306254";"  305997";"  273536";"   32461";"     257";"       0";"       0";"       0";"       0";"       0";"       0";"       0";"       0";"       0";"       0";"     257";"     257";"       0";"       0";"       0";"       0";"       0"
"Eindhoven Airport";"2022 January*";"    2220";"       0";"    1062";"    1025";"      37";"    1071";"    1035";"      36";"  149639";"  149639";"       0";"  125427";"  125427";"       0";"  275066";"  275066";"  246530";"   28536";"       0";"       0";"       0";"       0";"       0";"       0";"       0";"       0";"       0";"       0";"       0";"       0";"       0";"       0";"       0";"       0";"       0";"       0"
"Eindhoven Airport";"2022 February*";"    2238";"       0";"    1081";"    1029";"      52";"    1070";"    1035";"      35";"  148530";"  148242";"     288";"  160753";"  160635";"     118";"  309283";"  305034";"  272357";"   32677";"    4249";"    4018";"    4018";"       0";"       0";"       0";"       0";"       0";"       0";"       0";"       0";"     231";"     231";"       0";"       0";"       0";"       0";"       0"
"Eindhoven Airport";"2022 March*";"    2806";"       0";"    1346";"    1295";"      51";"    1354";"    1300";"      54";"  203066";"  202800";"     266";"  198709";"  198452";"     257";"  401775";"  393052";"  348500";"   44552";"    8723";"    8723";"    8723";"       0";"       0";"       0";"       0";"       0";"       0";"       0";"       0";"       0";"       0";"       0";"       0";"       0";"       0";"       0"
"Eindhoven Airport";"2022 April*";"    3504";"       0";"    1702";"    1632";"      70";"    1688";"    1649";"      39";"  259702";"  259337";"     365";"  286279";"  285905";"     374";"  545981";"  536134";"  473894";"   62240";"    9847";"    9847";"    9847";"       0";"       0";"       0";"       0";"       0";"       0";"       0";"       0";"       0";"       0";"       0";"       0";"       0";"       0";"       0"
"Eindhoven Airport";"2022 May*";"    3901";"       0";"    1884";"    1815";"      69";"    1884";"    1830";"      54";"  308586";"  308448";"     138";"  310095";"  309963";"     132";"  618681";"  603677";"  535103";"   68574";"   15004";"   15004";"   15004";"       0";"       0";"       0";"       0";"       0";"       0";"       0";"       0";"       0";"       0";"       0";"       0";"       0";"       0";"       0"
"Eindhoven Airport";"2022 June*";"    3858";"       0";"    1858";"    1806";"      52";"    1866";"    1816";"      50";"  307267";"  307154";"     113";"  323976";"  323860";"     116";"  631243";"  614908";"  546371";"   68537";"   16335";"   16335";"   16335";"       0";"       0";"       0";"       0";"       0";"       0";"       0";"       0";"       0";"       0";"       0";"       0";"       0";"       0";"       0"
"Eindhoven Airport";"2022 July*";"    4049";"       0";"    1954";"    1895";"      59";"    1955";"    1904";"      51";"  311307";"  311208";"      99";"  351339";"  351289";"      50";"  662646";"  643419";"  559862";"   83557";"   19227";"   19227";"   19227";"       0";"       0";"       0";"       0";"       0";"       0";"       0";"       0";"       0";"       0";"       0";"       0";"       0";"       0";"       0"
"Eindhoven Airport";"2022 August*";"    4067";"       0";"    1970";"    1918";"      52";"    1978";"    1924";"      54";"  350974";"  350455";"     519";"  327874";"  326946";"     928";"  678848";"  659980";"  569459";"   90521";"   18868";"   18837";"   18837";"       0";"       0";"       0";"       0";"      31";"      31";"       0";"       0";"       0";"       0";"       0";"       0";"       0";"       0";"       0"
"Eindhoven Airport";"2022 September*";"    3926";"       0";"    1901";"    1825";"      76";"    1899";"    1833";"      66";"  320394";"  319127";"    1267";"  316187";"  315136";"    1051";"  636581";"  620735";"  543068";"   77667";"   15846";"   15846";"   15846";"       0";"       0";"       0";"       0";"       0";"       0";"       0";"       0";"       0";"       0";"       0";"       0";"       0";"       0";"       0"
"Eindhoven Airport";"2022 October*";"    4043";"       0";"    1963";"    1904";"      59";"    1972";"    1895";"      77";"  338590";"  337701";"     889";"  331163";"  330165";"     998";"  669753";"  647591";"  560191";"   87400";"   22162";"   22162";"   22162";"       0";"       0";"       0";"       0";"       0";"       0";"       0";"       0";"       0";"       0";"       0";"       0";"       0";"       0";"       0"
"Eindhoven Airport";"2022 November*";"    2740";"       0";"    1337";"    1312";"      25";"    1346";"    1313";"      33";"  231369";"  231059";"     310";"  217048";"  216683";"     365";"  448417";"  430295";"  375554";"   54741";"   18122";"   18122";"   15301";"    2821";"       0";"       0";"       0";"       0";"       0";"       0";"       0";"       0";"       0";"       0";"       0";"       0";"       0";"       0"
